ytjämnhetstecken = ytj%C3%A4mnhetstecken-sv
ytterhylsa_till_maskinskärbrännare = ytterhylsa+till+maskinsk%C3%A4rbr%C3%A4nnare-sv
ytterligare_yrkande = ytterligare+yrkande-sv
ytterfyr = ytterfyr-sv
zolasartan = zolasartan-sv
ytterskruv_på_mynningen = ytterskruv+p%C3%A5+mynningen-sv
yttre_fotoelektrisk_effekt = yttre+fotoelektrisk+effekt-sv
ytförbränning = ytf%C3%B6rbr%C3%A4nning-sv
zonal_ozontransport = zonal+ozontransport-sv
y-jordmån = Y-jordm%C3%A5n-sv
ytterligare_skriftligt_yttrande = ytterligare+skriftligt+yttrande-sv
y1g = Y1G-sv
yttransit = yttransit-sv
yttre_spårsida = yttre+sp%C3%A5rsida-sv
ystningstank = ystningstank-sv
yrkesutbildad_arbetskraft = yrkesutbildad+arbetskraft-sv
yteffektflöde = yteffektfl%C3%B6de-sv
yrkesdomare = yrkesdomare-sv
ytbehandlingsmedel = ytbehandlingsmedel-sv
ytlig_brunfärgning = ytlig+brunf%C3%A4rgning-sv
yttre_bakkappa = yttre+bakkappa-sv
ytterligare_föreskrifter_för_tillämpningen_av = ytterligare+f%C3%B6reskrifter+f%C3%B6r+till%C3%A4mpningen+av-sv
ytliga_dosekvivalentindexet_i_en_punkt = ytliga+dosekvivalentindexet+i+en+punkt-sv
yttre_knapp = yttre+knapp-sv
ytligt_prov = ytligt+prov-sv
zukapsaicin = zukapsaicin-sv
zolenzepin = zolenzepin-sv
ytmeta = ytmeta-sv
zaprinast = zaprinast-sv
yta_med_valshud = yta+med+valshud-sv
zikavirusinfektion = zikavirusinfektion-sv
zombie = zombie-sv
zucchinigulmosaikvirus = zucchinigulmosaikvirus-sv
yotta = yotta-sv
yttätad_hård_träfiberskiva = ytt%C3%A4tad+h%C3%A5rd+tr%C3%A4fiberskiva-sv
y = y-sv
zindoxifen = zindoxifen-sv
yttersida = yttersida-sv
ytterligare_tolftedel = ytterligare+tolftedel-sv
ytterände = ytter%C3%A4nde-sv
yrkesstadga = yrkesstadga-sv
yteffektfordon = yteffektfordon-sv
yrkesarbetare = yrkesarbetare-sv
ytvattenvärme = ytvattenv%C3%A4rme-sv
zirkonium = zirkonium-sv
ytterligare_medel = ytterligare+medel-sv
ytterfoder = ytterfoder-sv
yttätning = ytt%C3%A4tning-sv
ytladdningstäthet = ytladdningst%C3%A4thet-sv
ytkemi = ytkemi-sv
zwd = ZWD-sv
ytkorrektion = ytkorrektion-sv
yrkesmässig_användare = yrkesm%C3%A4ssig+anv%C3%A4ndare-sv
zillmering = zillmering-sv
ytdiagnostik = ytdiagnostik-sv
zoonotiskt_smittämne = zoonotiskt+smitt%C3%A4mne-sv
ygl = YGL-sv
ytkontakt = ytkontakt-sv
yrkesarbete = yrkesarbete-sv
y-skuren_kristall = Y-skuren+kristall-sv
yttre_miljökomponent = yttre+milj%C3%B6komponent-sv
ytfyllning = ytfyllning-sv
yrkesförbund = yrkesf%C3%B6rbund-sv
zenarestat = zenarestat-sv
ytterligare_referenskvantitet = ytterligare+referenskvantitet-sv
ytrekombinationsström = ytrekombinationsstr%C3%B6m-sv
zetidolin = zetidolin-sv
yttre_hydrauliskt_genombrott = yttre+hydrauliskt+genombrott-sv
zinkoxid = zinkoxid-sv
ytsprickning = ytsprickning-sv
zelens_olikhet = Zelens+olikhet-sv
yrkesinriktad_rehabilitering = yrkesinriktad+rehabilitering-sv
yrkesmässig_aktör = yrkesm%C3%A4ssig+akt%C3%B6r-sv
yle = Yle-sv
zonindelning_baserad_på_det_sannolika_värdet_av_fiskpopulationen = zonindelning+baserad+p%C3%A5+det+sannolika+v%C3%A4rdet+av+fiskpopulationen-sv
ytfriktion = ytfriktion-sv
zephirgarn = zephirgarn-sv
ytsanering = ytsanering-sv
ytsprickor = ytsprickor-sv
z-transform = Z-transform-sv
yrken_inom_konstindustri = yrken+inom+konstindustri-sv
yttre_gräns = yttre+gr%C3%A4ns-sv
yttryck_i_ett_annulärt_utrymme = yttryck+i+ett+annul%C3%A4rt+utrymme-sv
y1b = Y1B-sv
ytgenomträngande_profil = ytgenomtr%C3%A4ngande+profil-sv
yrkeshygieniker = yrkeshygieniker-sv
yttrande_från_chmp/cvmp = yttrande+fr%C3%A5n+CHMP%2FCVMP-sv
zaire = Zaire-sv
yttersta_randområde = yttersta+randomr%C3%A5de-sv
zepastin = zepastin-sv
yttre_förluster_i_fiber = yttre+f%C3%B6rluster+i+fiber-sv
yttre_tryckutjämning = yttre+tryckutj%C3%A4mning-sv
ympkvist = ympkvist-sv
yttre_skal = yttre+skal-sv
ytspänningsmätare = ytsp%C3%A4nningsm%C3%A4tare-sv
ytavvägning = ytavv%C3%A4gning-sv
yrkesförberedande_utbildning_på_högstadium_och_gymnasium,_antal_lärare = yrkesf%C3%B6rberedande+utbildning+p%C3%A5+h%C3%B6gstadium+och+gymnasium%2C+antal+l%C3%A4rare-sv
y-korsning = Y-korsning-sv
ytmognad = ytmognad-sv
ytbeslag = ytbeslag-sv
yrkesutbildningsbidrag = yrkesutbildningsbidrag-sv
yrkesetiska_regler = yrkesetiska+regler-sv
yrkeseksem = yrkeseksem-sv
yrkesförberedande_skola = yrkesf%C3%B6rberedande+skola-sv
zeneremission = zeneremission-sv
ytterligare_kapitalbaskrav = ytterligare+kapitalbaskrav-sv
zea_mays_convar.ceratina = Zea+mays+convar.ceratina-sv
ytspäckning = ytsp%C3%A4ckning-sv
yrkeshögskola = yrkesh%C3%B6gskola-sv
ytfaner = ytfaner-sv
zeranol = Zeranol-sv
yttertemperaturgivare = yttertemperaturgivare-sv
yttre_anpassningsenhet = yttre+anpassningsenhet-sv
zyglo-inspektion = Zyglo-inspektion-sv
zofenoprilat = zofenoprilat-sv
yrkesutveckling = yrkesutveckling-sv
zeolit = zeolit-sv
ytpassivering = ytpassivering-sv
yrkeshygieniskt_luftbehov = yrkeshygieniskt+luftbehov-sv
ytkorrosion = ytkorrosion-sv
zenitdistans = zenitdistans-sv
yxblad = yxblad-sv
ympa = ympa-sv
youtube-kanal = YouTube-kanal-sv
yngellök = yngell%C3%B6k-sv
zon_för_onormal_hörbarhet = zon+f%C3%B6r+onormal+h%C3%B6rbarhet-sv
yttre_saltelektrod = yttre+saltelektrod-sv
yule-process = Yule-process-sv
yrkesförbud = yrkesf%C3%B6rbud-sv
y-axel = y-axel-sv
zns = ZnS-sv
zanoteron = zanoteron-sv
yessotoxin = yessotoxin-sv
yankee-marknaden = Yankee-marknaden-sv
yrke = yrke-sv
ytdiffusion = ytdiffusion-sv
zenerström = zenerstr%C3%B6m-sv
yttre_åtgärder = yttre+%C3%A5tg%C3%A4rder-sv
ytreaktion = ytreaktion-sv
ytvattenförekomst = ytvattenf%C3%B6rekomst-sv
zymomonas = Zymomonas-sv
yules_hyperboliska_fördelning = Yules+hyperboliska+f%C3%B6rdelning-sv
yttre_elektron = yttre+elektron-sv
zoonotisk_salmonella = zoonotisk+salmonella-sv
ytdefekter = ytdefekter-sv
yttre_tryck = yttre+tryck-sv
yuv = YUV-sv
yngel = yngel-sv
zirkit = zirkit-sv
zodiakljus = zodiakljus-sv
zabiciprilat = zabiciprilat-sv
ytskikt_i_sandwichlaminat = ytskikt+i+sandwichlaminat-sv
ytrivhållfasthetstest = ytrivh%C3%A5llfasthetstest-sv
y-grening = Y-grening-sv
ytrengöring = ytreng%C3%B6ring-sv
yttermembran = yttermembran-sv
yttrande = yttrande-sv
yttrande-_och_informationsfrihet = yttrande-+och+informationsfrihet-sv
ytredistribution = ytredistribution-sv
yrkesundervisning = yrkesundervisning-sv
yttertyg = yttertyg-sv
ytkontaminering = ytkontaminering-sv
ytterfacksram = ytterfacksram-sv
yttranden_skall_inte_vara_bindande = yttranden+skall+inte+vara+bindande-sv
ytjämnhetsnivå = ytj%C3%A4mnhetsniv%C3%A5-sv
yrkesslungsjukdom = yrkesslungsjukdom-sv
yttre_miljö = yttre+milj%C3%B6-sv
yttre_kona = yttre+kona-sv
zilpaterol = zilpaterol-sv
yttertröskel = yttertr%C3%B6skel-sv
zofikonazol = zofikonazol-sv
ytterligare_riskviktning = ytterligare+riskviktning-sv
ympkniv_för_klyvympning = ympkniv+f%C3%B6r+klyvympning-sv
yrkesverksam_på_hälsoområdet = yrkesverksam+p%C3%A5+h%C3%A4lsoomr%C3%A5det-sv
ytspaningsledare = ytspaningsledare-sv
ytterligare_avskrivningar = ytterligare+avskrivningar-sv
zinkoleat = zinkoleat-sv
zebrano = zebrano-sv
zikavirus = zikavirus-sv
zymas = zymas-sv
yttre_skadeförorsakande_faktor = yttre+skadef%C3%B6rorsakande+faktor-sv
ytresistivitet = ytresistivitet-sv
zaltidin = zaltidin-sv
ympkniv_för_triangulering = ympkniv+f%C3%B6r+triangulering-sv
ympstick-förfarande = ympstick-f%C3%B6rfarande-sv
yrkesexamen = yrkesexamen-sv
yrkesmässig_rörlighet = yrkesm%C3%A4ssig+r%C3%B6rlighet-sv
zooteknisk_behandling = zooteknisk+behandling-sv
ymodem = Ymodem-sv
yttre_avbrottssignal = yttre+avbrottssignal-sv
zinkoxidpapper = zinkoxidpapper-sv
zenerbrus = zenerbrus-sv
zinklegering = zinklegering-sv
ympkombination = ympkombination-sv
ytblixt = ytblixt-sv
yngelträd_med_sent_kläckande_individer = yngeltr%C3%A4d+med+sent+kl%C3%A4ckande+individer-sv
ytljudtrycksnivå = ytljudtrycksniv%C3%A5-sv
yrkesmässig_återanpassning = yrkesm%C3%A4ssig+%C3%A5teranpassning-sv
yig-styrd_oscillator = YIG-styrd+oscillator-sv
zepto = zepto-sv
ytterligare_tillämpningsföreskrifter = ytterligare+till%C3%A4mpningsf%C3%B6reskrifter-sv
zontariff = zontariff-sv
ytsprickor_under_mynning = ytsprickor+under+mynning-sv
ythastighet_mitt_i_vattendraget = ythastighet+mitt+i+vattendraget-sv
yta = yta-sv
zygotens_fastväxande_i_uterus = zygotens+fastv%C3%A4xande+i+uterus-sv
yuppie = yuppie-sv
zileuton = zileuton-sv
yttre_fast_lamellskena = yttre+fast+lamellskena-sv
yrkesfärdigheter = yrkesf%C3%A4rdigheter-sv
ytblåsa = ytbl%C3%A5sa-sv
ytvattenväxter = ytvattenv%C3%A4xter-sv
zopolrestat = zopolrestat-sv
ytterklaff = ytterklaff-sv
zidapamid = zidapamid-sv
ytavlösning = ytavl%C3%B6sning-sv
yttersta_moderbolag = yttersta+moderbolag-sv
yttalakter = yttalakter-sv
ytteruttag = ytteruttag-sv
zonaljord = zonaljord-sv
ytluftning = ytluftning-sv
ystningskar = ystningskar-sv
zinklaktat = zinklaktat-sv
yttre_kantblomma = yttre+kantblomma-sv
zrs = ZRS-sv
ytterfäste_breguetspiral = ytterf%C3%A4ste+breguetspiral-sv
ytdos = ytdos-sv
ytbelastning = ytbelastning-sv
ytterligare_utlopp = ytterligare+utlopp-sv
yttre_källartrappa = yttre+k%C3%A4llartrappa-sv
ytdiagram = ytdiagram-sv
yttre_del = yttre+del-sv
zebra = zebra-sv
y-d_start = Y-D+start-sv
yttre_debye-längd = yttre+Debye-l%C3%A4ngd-sv
yrkesvägledning = yrkesv%C3%A4gledning-sv
ytskiktets_vidhäftning = ytskiktets+vidh%C3%A4ftning-sv
ytmätningslära = ytm%C3%A4tningsl%C3%A4ra-sv
ytterfiber = ytterfiber-sv
ytström = ytstr%C3%B6m-sv
ystkar = ystkar-sv
ziram = ziram-sv
ytsterilisering = ytsterilisering-sv
yrkeserfarenhet = yrkeserfarenhet-sv
zwitterjon = zwitterjon-sv
yrkesklassificering = yrkesklassificering-sv
zomebazam = zomebazam-sv
ytinjektering = ytinjektering-sv
ytbevattningsaggregat = ytbevattningsaggregat-sv
zaleplon = zaleplon-sv
ytterring = ytterring-sv
ythärdning = yth%C3%A4rdning-sv
yttre_nödbelysning = yttre+n%C3%B6dbelysning-sv
yrkandena_i_ansökan = yrkandena+i+ans%C3%B6kan-sv
zipfs_lag = Zipfs+lag-sv
zonala_klotytefunktioner = zonala+klotytefunktioner-sv
ytbevattning = ytbevattning-sv
zinostatinstimalamer = zinostatinstimalamer-sv
zindotrin = zindotrin-sv
yrkeskvalifikation = yrkeskvalifikation-sv
yrkesbetingad_talrubbning = yrkesbetingad+talrubbning-sv
ytkontaminerat_föremål = ytkontaminerat+f%C3%B6rem%C3%A5l-sv
yttre_begränsning_av_störämnestillväxt = yttre+begr%C3%A4nsning+av+st%C3%B6r%C3%A4mnestillv%C3%A4xt-sv
ytaktivt_ämne = ytaktivt+%C3%A4mne-sv
zolpidem = zolpidem-sv
zinkkromat = zinkkromat-sv
ytkartslut = ytkartslut-sv
ympmedel = ympmedel-sv
yukawa-potential = Yukawa-potential-sv
ytsprickor_i_osten = ytsprickor+i+osten-sv
zoomobjektiv = zoomobjektiv-sv
yrkesinriktat_högstadium = yrkesinriktat+h%C3%B6gstadium-sv
ytbeläggning_av_trä = ytbel%C3%A4ggning+av+tr%C3%A4-sv
zonkod = zonkod-sv
yrkessammanslutning = yrkessammanslutning-sv
zotepin = zotepin-sv
zinkkolik = zinkkolik-sv
yttre_hörnsvets = yttre+h%C3%B6rnsvets-sv
z-matris = z-matris-sv
zonplan = zonplan-sv
ytterligare_inkomster = ytterligare+inkomster-sv
zondiameter_vid_diskdiffusion = zondiameter+vid+diskdiffusion-sv
yrkesmässig_slakt = yrkesm%C3%A4ssig+slakt-sv
ytledes = ytledes-sv
zonexpropriation = zonexpropriation-sv
zooma_föregående_fönster = zooma+f%C3%B6reg%C3%A5ende+f%C3%B6nster-sv
yrkesmässig_utveckling = yrkesm%C3%A4ssig+utveckling-sv
zenitlod = zenitlod-sv
ympris = ympris-sv
yttrium = yttrium-sv
zedrak = zedrak-sv
z-jordmån = Z-jordm%C3%A5n-sv
zatebradin = zatebradin-sv
ympbänk = ympb%C3%A4nk-sv
yrkeserfaren = yrkeserfaren-sv
ytvattenvård = ytvattenv%C3%A5rd-sv
z-test = z-test-sv
yttre_isolering = yttre+isolering-sv
yrkesinspektionsläkarverksamhet = yrkesinspektionsl%C3%A4karverksamhet-sv
yrkesutbildande_gymnasieskola = yrkesutbildande+gymnasieskola-sv
yttre_förhållande = yttre+f%C3%B6rh%C3%A5llande-sv
ytterligare_säkerhet = ytterligare+s%C3%A4kerhet-sv
yttre_miljöfaktor = yttre+milj%C3%B6faktor-sv
yttertrumma_i_kemtvättmaskin = yttertrumma+i+kemtv%C3%A4ttmaskin-sv
ytfaktor = ytfaktor-sv
ytbehandling_av_glas = ytbehandling+av+glas-sv
zagreb = Zagreb-sv
yrkesfortbildning = yrkesfortbildning-sv
zephir = zephir-sv
ythorisontens_djup = ythorisontens+djup-sv
ytlödning = ytl%C3%B6dning-sv
yrkesställning = yrkesst%C3%A4llning-sv
y-parallax = y-parallax-sv
zifrosilon = zifrosilon-sv
zangger-kommittén = Zangger-kommitt%C3%A9n-sv
yl-faktor = yl-faktor-sv
ytterligare_åtgärder = ytterligare+%C3%A5tg%C3%A4rder-sv
yttre_processdata = yttre+processdata-sv
zink-silver-legering = zink-silver-legering-sv
yrkande_av_allmän_åklagare = yrkande+av+allm%C3%A4n+%C3%A5klagare-sv
zoliprofen = zoliprofen-sv
zomepirak = zomepirak-sv
ytterkant = ytterkant-sv
yttre_investeringsplan = yttre+investeringsplan-sv
ytkälleskjutning = ytk%C3%A4lleskjutning-sv
ylleaktigt_grepp = ylleaktigt+grepp-sv
zinkdibutylditiokarbamat = zinkdibutylditiokarbamat-sv
ytavlagring = ytavlagring-sv
yo!-festivalen = YO%21-festivalen-sv
ytpyrometer = ytpyrometer-sv
yttre_gängdiameter = yttre+g%C3%A4ngdiameter-sv
yrkesmässig_ansvarsförsäkring = yrkesm%C3%A4ssig+ansvarsf%C3%B6rs%C3%A4kring-sv
ystningsavdelning = ystningsavdelning-sv
zinviroxim = zinviroxim-sv
zooma_nästa_fönster = zooma+n%C3%A4sta+f%C3%B6nster-sv
yrkesrisker = yrkesrisker-sv
ytterligare_arvoden = ytterligare+arvoden-sv
ytlimning = ytlimning-sv
zinkdietylditiokarbamat = zinkdietylditiokarbamat-sv
yttillstånd = yttillst%C3%A5nd-sv
zylofuramin = zylofuramin-sv
zon_som_är_fri_från_massförstörelsevapen = zon+som+%C3%A4r+fri+fr%C3%A5n+massf%C3%B6rst%C3%B6relsevapen-sv
yorkshire-ullfett = Yorkshire-ullfett-sv
yttre_förortsområde = yttre+f%C3%B6rortsomr%C3%A5de-sv
zamifenacin = zamifenacin-sv
zygotens_cellulära_organisation = zygotens+cellul%C3%A4ra+organisation-sv
ytfärg = ytf%C3%A4rg-sv
yrkesregister = yrkesregister-sv
ytbehandling_av_isbana = ytbehandling+av+isbana-sv
ytdensitetsvariation = ytdensitetsvariation-sv
zalospiron = zalospiron-sv
yaoundé = Yaound%C3%A9-sv
yag = YAG-sv
yangon = Yangon-sv
zinkbländestruktur = zinkbl%C3%A4ndestruktur-sv
ympcell = ympcell-sv
yllemuslin = yllemuslin-sv
yrkeskompetensbevis_för_förare = yrkeskompetensbevis+f%C3%B6r+f%C3%B6rare-sv
ytfilm = ytfilm-sv
yttra_sig = yttra+sig-sv
yttre_fixpunkt = yttre+fixpunkt-sv
yttre_slinga = yttre+slinga-sv
z-poäng = z-po%C3%A4ng-sv
yttrandefrihet = yttrandefrihet-sv
yttäthet = ytt%C3%A4thet-sv
ytterkapsyl = ytterkapsyl-sv
yttertakselement = yttertakselement-sv
ymodem-protokoll = Ymodem-protokoll-sv
zymocyt = zymocyt-sv
yttre_brus = yttre+brus-sv
yrkande_om_hävande_av_beslag = yrkande+om+h%C3%A4vande+av+beslag-sv
yttre_tecken_på_förmögenhet = yttre+tecken+p%C3%A5+f%C3%B6rm%C3%B6genhet-sv
yttre_belastningsimpedans = yttre+belastningsimpedans-sv
yttre_vätsketryck = yttre+v%C3%A4tsketryck-sv
ydg-h = YDG-H-sv
zabaione = zabaione-sv
ytmorän = ytmor%C3%A4n-sv
yttersta_moderföretag = yttersta+moderf%C3%B6retag-sv
ytpotential = ytpotential-sv
zombieföretag = zombief%C3%B6retag-sv
ytskiktet = ytskiktet-sv
yngelkaka = yngelkaka-sv
zonrening = zonrening-sv
zinterol = zinterol-sv
zoogloeabakterie = zoogloeabakterie-sv
ytspänning = ytsp%C3%A4nning-sv
ytbeläggning = ytbel%C3%A4ggning-sv
ytekvivalent_partikeldiameter = ytekvivalent+partikeldiameter-sv
zafirlukast = zafirlukast-sv
zibetdjur = zibetdjur-sv
zonad_lins = zonad+lins-sv
ziprasidon = ziprasidon-sv
yrkanden_i_andra_hand = yrkanden+i+andra+hand-sv
yxkarl = yxkarl-sv
ytbehandling_med_bitumen = ytbehandling+med+bitumen-sv
ytrekombineringshastighet = ytrekombineringshastighet-sv
ympning_med_ympkvist = ympning+med+ympkvist-sv
yrkesstatus = yrkesstatus-sv
ypg = YPG-sv
ympbärare = ympb%C3%A4rare-sv
zhukovsky's_teori = Zhukovsky%27s+teori-sv
zetta = zetta-sv
yttre_lagerring = yttre+lagerring-sv
yttre_hörselgång = yttre+h%C3%B6rselg%C3%A5ng-sv
ytlig_skottskada = ytlig+skottskada-sv
zirkonium-aluminiumsilikat,_eldfasta_keramiska_fibrer = zirkonium-aluminiumsilikat%2C+eldfasta+keramiska+fibrer-sv
yenish = yenish-sv
ytvågor = ytv%C3%A5gor-sv
zanella = zanella-sv
z8000 = Z8000-sv
ympkniv = ympkniv-sv
y-fog = Y-fog-sv
zuklomifen = zuklomifen-sv
yrkesbrandkår = yrkesbrandk%C3%A5r-sv
yttrande_om_rättsstatsprincipen = yttrande+om+r%C3%A4ttsstatsprincipen-sv
zmodem = Zmodem-sv
yrkesförberedande_utbildning_på_högstadium_och_gymnasium,_antal_elever = yrkesf%C3%B6rberedande+utbildning+p%C3%A5+h%C3%B6gstadium+och+gymnasium%2C+antal+elever-sv
ytlig_plöjning = ytlig+pl%C3%B6jning-sv
zinkbacitracin = zinkbacitracin-sv
zonpris = zonpris-sv
zardaverin = zardaverin-sv
yrkesutbildningsbevis = yrkesutbildningsbevis-sv
yrkesfruktodling = yrkesfruktodling-sv
zabicipril = zabicipril-sv
zip-fil = zip-fil-sv
yngre_brunkol = yngre+brunkol-sv
ytkylning = ytkylning-sv
ymnighetskvot = ymnighetskvot-sv
yttersta_del_hos_ringspinnmaskin = yttersta+del+hos+ringspinnmaskin-sv
yerkum = yerkum-sv
yttre_rymden = yttre+rymden-sv
ympningsmaskin = ympningsmaskin-sv
yrkande_om_hänvisning = yrkande+om+h%C3%A4nvisning-sv
zinkcyanid = zinkcyanid-sv
ytaktivitet = ytaktivitet-sv
yttre_kompasspejl = yttre+kompasspejl-sv
ypj = YPJ-sv
ympplantage = ympplantage-sv
zenitrefraktion = zenitrefraktion-sv
ylleindustri = ylleindustri-sv
youden-kvadrat = Youden-kvadrat-sv
yttermunstycke = yttermunstycke-sv
ytavkolning = ytavkolning-sv
yrkesförberedande_utbildning = yrkesf%C3%B6rberedande+utbildning-sv
yrkesskicklighet = yrkesskicklighet-sv
ytfel = ytfel-sv
y-axel = Y-axel-sv
zon_med_lika_signalamplitud = zon+med+lika+signalamplitud-sv
zooma_ut = zooma+ut-sv
ympmaterial = ympmaterial-sv
ympningsmaskin_för_bänkplacering = ympningsmaskin+f%C3%B6r+b%C3%A4nkplacering-sv
zapatero = zapatero-sv
ytpåläggning_med_mjuklödning = ytp%C3%A5l%C3%A4ggning+med+mjukl%C3%B6dning-sv
ytterligare_likviditetsövervakningsmått = ytterligare+likviditets%C3%B6vervakningsm%C3%A5tt-sv
ythårdlödning = yth%C3%A5rdl%C3%B6dning-sv
yoghurt = yoghurt-sv
yterosion = yterosion-sv
yrkesförare = yrkesf%C3%B6rare-sv
zorubicin = zorubicin-sv
zanzibarkopal = Zanzibarkopal-sv
yttre_emitterresistans = yttre+emitterresistans-sv
z-plot = Z-plot-sv
zonisamid = zonisamid-sv
ytmärken = ytm%C3%A4rken-sv
ying-yang-spole = Ying-Yang-spole-sv
ytbehandlingsavfall = ytbehandlingsavfall-sv
ympbastard = ympbastard-sv
y-ledning = Y-ledning-sv
ytrekombinationshastighet = ytrekombinationshastighet-sv
ytmodifierad_övergång = ytmodifierad+%C3%B6verg%C3%A5ng-sv
yrkesinriktning = yrkesinriktning-sv
yttre_risk = yttre+risk-sv
ytterbark = ytterbark-sv
zingel = zingel-sv
zieglermetod = Zieglermetod-sv
ytluckring = ytluckring-sv
yrkesrisk = yrkesrisk-sv
ytsampling = ytsampling-sv
ylang-ylang = ylang-ylang-sv
yrkesutbildning_inom_industri = yrkesutbildning+inom+industri-sv
y2g = Y2G-sv
zygot = zygot-sv
yrkesförening = yrkesf%C3%B6rening-sv
ytfibrillering_av_garn = ytfibrillering+av+garn-sv
zoxazolamin = zoxazolamin-sv
ymphybrid = ymphybrid-sv
zeroth-ordning = zeroth-ordning-sv
yrkesmässig_kompetens = yrkesm%C3%A4ssig+kompetens-sv
yazidier = yazidier-sv
zonklimataggregat = zonklimataggregat-sv
yttre_störningar = yttre+st%C3%B6rningar-sv
ytskiktsdetektor = ytskiktsdetektor-sv
z-gränssnitt = Z-gr%C3%A4nssnitt-sv
ytbrus = ytbrus-sv
yttextur = yttextur-sv
yttemperatur = yttemperatur-sv
yrkeskunskap = yrkeskunskap-sv
ypga = YPGA-sv
ytmjuklödning = ytmjukl%C3%B6dning-sv
zinkklorid = zinkklorid-sv
zolamin = zolamin-sv
zontid = zontid-sv
ytbeskaffenhet = ytbeskaffenhet-sv
ytvågledare = ytv%C3%A5gledare-sv
zimeldin = zimeldin-sv
zoloperon = zoloperon-sv
yerzley-oscillograf = Yerzley-oscillograf-sv
yttre_nod = yttre+nod-sv
ytgenerering = ytgenerering-sv
yrkesfältman = yrkesf%C3%A4ltman-sv
ytkristallisation = ytkristallisation-sv
zoledronsyra = zoledronsyra-sv
z-system = z-system-sv
yttre_pormynning = yttre+pormynning-sv
ytanrikningsskikt = ytanrikningsskikt-sv
ytterapi = ytterapi-sv
ytterlufttermometer = ytterlufttermometer-sv
yttorr = yttorr-sv
zakoprid = zakoprid-sv
zafuleptin = zafuleptin-sv
ytwebb = ytwebb-sv
zon_för_positionering_av_huvud = zon+f%C3%B6r+positionering+av+huvud-sv
ytvågsutbredning = ytv%C3%A5gsutbredning-sv
zikafeber = zikafeber-sv
yrkeskunskaper = yrkeskunskaper-sv
ytterring_för_verkbotten = ytterring+f%C3%B6r+verkbotten-sv
ytlig_inguinallymfknut = ytlig+inguinallymfknut-sv
ytspänning_i_vatten = ytsp%C3%A4nning+i+vatten-sv
zirkoniumnitrat = zirkoniumnitrat-sv
y-fyrpolsparameter = y-fyrpolsparameter-sv
ytfördröjning = ytf%C3%B6rdr%C3%B6jning-sv
yttrande_från_juridiska_avdelningen = yttrande+fr%C3%A5n+juridiska+avdelningen-sv
zoniklezol = zoniklezol-sv
yrkesverksam_inom_vattenlevande_djurs_hälsa = yrkesverksam+inom+vattenlevande+djurs+h%C3%A4lsa-sv
yrsel = yrsel-sv
yrkesbetingad_irreversibel_luftvägsobstruktion = yrkesbetingad+irreversibel+luftv%C3%A4gsobstruktion-sv
yttranderätt = yttrander%C3%A4tt-sv
yrkesfiske = yrkesfiske-sv
zonering = zonering-sv
zucchini = zucchini-sv
ytterligare_tilldelning = ytterligare+tilldelning-sv
yttrande_i_form_av_en_skrivelse = yttrande+i+form+av+en+skrivelse-sv
ytbelagd_skiva = ytbelagd+skiva-sv
yta_som_bevattnas_direkt_från_huvudkanal = yta+som+bevattnas+direkt+fr%C3%A5n+huvudkanal-sv
yrkesodlare = yrkesodlare-sv
zoonotisk_infektion = zoonotisk+infektion-sv
yrkande_om_ersättning_för_rättegångskostnader = yrkande+om+ers%C3%A4ttning+f%C3%B6r+r%C3%A4tteg%C3%A5ngskostnader-sv
ytterbium = ytterbium-sv
yrkesklassifikation = yrkesklassifikation-sv
ytstabilitet = ytstabilitet-sv
ytterligare_förädling = ytterligare+f%C3%B6r%C3%A4dling-sv
ytlångrevsfartyg_för_tonfiskfiske = ytl%C3%A5ngrevsfartyg+f%C3%B6r+tonfiskfiske-sv
zea = ZEA-sv
yrkesindelad_sysselsättningsstatistik = yrkesindelad+syssels%C3%A4ttningsstatistik-sv
ytrivhållfasthetsprovning = ytrivh%C3%A5llfasthetsprovning-sv
zinkskada = zinkskada-sv
yrkeskonsulent = yrkeskonsulent-sv
yttre_skyddsvall = yttre+skyddsvall-sv
z-riktning = z-riktning-sv
yrkeshygieniskt_gränsvärde = yrkeshygieniskt+gr%C3%A4nsv%C3%A4rde-sv
yttre_hjärtmassage = yttre+hj%C3%A4rtmassage-sv
ytfaner_på_baksidan = ytfaner+p%C3%A5+baksidan-sv
z = z-sv
ythartslager = ythartslager-sv
zinkkelat = zinkkelat-sv
zonalitet = zonalitet-sv
zapizolam = zapizolam-sv
ytvågsökare = ytv%C3%A5gs%C3%B6kare-sv
ythårdhet = yth%C3%A5rdhet-sv
ytavrinning = ytavrinning-sv
yrkesutbildad_medarbetare = yrkesutbildad+medarbetare-sv
ytterväggselement = ytterv%C3%A4ggselement-sv
ytvattenavrinning = ytvattenavrinning-sv
yttre_sortering = yttre+sortering-sv
yrkestrafik = yrkestrafik-sv
yrkesregler = yrkesregler-sv
ytterlår = ytterl%C3%A5r-sv
ympning_på_rot = ympning+p%C3%A5+rot-sv
yrkesutövare_inom_kulturarvsområdet = yrkesut%C3%B6vare+inom+kulturarvsomr%C3%A5det-sv
ytkrypning = ytkrypning-sv
ytvattenföringsdiagram = ytvattenf%C3%B6ringsdiagram-sv
yta_med_konkav-konvex_form = yta+med+konkav-konvex+form-sv
ymp = ymp-sv
ytspricka = ytspricka-sv
ytslira = ytslira-sv
ytredistribution_av_gallium_med_diffusion = ytredistribution+av+gallium+med+diffusion-sv
yop = YOP-sv
zoomning = zoomning-sv
zinkacetat = zinkacetat-sv
ympvax = ympvax-sv
ytläckning = ytl%C3%A4ckning-sv
yrkesmässig_segregering = yrkesm%C3%A4ssig+segregering-sv
ytfukt = ytfukt-sv
zonventil = zonventil-sv
zaltoprofen = zaltoprofen-sv
zinksulfat = zinksulfat-sv
zonnummer = zonnummer-sv
zineb = zineb-sv
yttrandet_avgivet_den..._ännu_inte_offentliggjort_i_egt. = Yttrandet+avgivet+den...+%C3%84nnu+inte+offentliggjort+i+EGT.-sv
ytternät = yttern%C3%A4t-sv
zidometacin = zidometacin-sv
zolmitriptan = zolmitriptan-sv
ytteremballage = ytteremballage-sv
yrke_inom_gruvindustrin = yrke+inom+gruvindustrin-sv
yrkesverksam_ålder = yrkesverksam+%C3%A5lder-sv
ytstyrd_backström = ytstyrd+backstr%C3%B6m-sv
yttre_släntfot = yttre+sl%C3%A4ntfot-sv
yrken_inom_metallurgi = yrken+inom+metallurgi-sv
yrkesansvarsförsäkring = yrkesansvarsf%C3%B6rs%C3%A4kring-sv
zink-luftbatteri = zink-luftbatteri-sv
zinkrik_färg = zinkrik+f%C3%A4rg-sv
yttersta_del_hos_ringtvinnmaskin = yttersta+del+hos+ringtvinnmaskin-sv
zolimidin = zolimidin-sv
yttre_dynrygg = yttre+dynrygg-sv
ytkapacitans = ytkapacitans-sv
ytgeologi = ytgeologi-sv
ytstruktur_bildad_genom_korrosion_på_polerat_stål = ytstruktur+bildad+genom+korrosion+p%C3%A5+polerat+st%C3%A5l-sv
yrkesmässiga_tjänster = yrkesm%C3%A4ssiga+tj%C3%A4nster-sv
zonalindex = zonalindex-sv
yukawa-kärna = Yukawa-k%C3%A4rna-sv
ympning = ympning-sv
ytgeometri = ytgeometri-sv
ytterdiameter_hos_den_inspelade_ytan = ytterdiameter+hos+den+inspelade+ytan-sv
yta_mellan_horisonter = yta+mellan+horisonter-sv
yta_som_skall_besås = yta+som+skall+bes%C3%A5s-sv
yttre_skyddsmur = yttre+skyddsmur-sv
zonalcirkulation = zonalcirkulation-sv
yttre_säkerhetsgräns = yttre+s%C3%A4kerhetsgr%C3%A4ns-sv
yrkesintegritet = yrkesintegritet-sv
ympkultur = ympkultur-sv
ytlig_kroppsvisitation = ytlig+kroppsvisitation-sv
yttre_komponentskikt = yttre+komponentskikt-sv
ytpåläggning_med_lödning = ytp%C3%A5l%C3%A4ggning+med+l%C3%B6dning-sv
yankeebond = yankeebond-sv
yttre_transistorelement = yttre+transistorelement-sv
ytvattenklassificering = ytvattenklassificering-sv
ytplätering = ytpl%C3%A4tering-sv
zmodem-protokoll = Zmodem-protokoll-sv
ytfiltrering = ytfiltrering-sv
ytgrovhetsfaktor = ytgrovhetsfaktor-sv
ytbehandling_av_tank = ytbehandling+av+tank-sv
z = Z-sv
yamoussoukro = Yamoussoukro-sv
zontemperering = zontemperering-sv
zink-kolcell = zink-kolcell-sv
zolazepam = zolazepam-sv
zinkfrossa = zinkfrossa-sv
zeemaneffekt = Zeemaneffekt-sv
yrkesmässig_fruktodling = yrkesm%C3%A4ssig+fruktodling-sv
zonprogram = zonprogram-sv
yrkesorganisation = yrkesorganisation-sv
ytpåläggning_med_hårdlödning = ytp%C3%A5l%C3%A4ggning+med+h%C3%A5rdl%C3%B6dning-sv
yrkesutbildning_för_vuxna = yrkesutbildning+f%C3%B6r+vuxna-sv
ympställe = ympst%C3%A4lle-sv
zinkcitrat = zinkcitrat-sv
york-antwerpen-reglerna = York-Antwerpen-reglerna-sv
zenitdämpning_i_en_riktning = zenitd%C3%A4mpning+i+en+riktning-sv
yohimbinsyra = yohimbinsyra-sv
zirkonglasyr = zirkonglasyr-sv
ytmontering = ytmontering-sv
ytojämnhet = ytoj%C3%A4mnhet-sv
yttre_kombination = yttre+kombination-sv
yttre_plasticering = yttre+plasticering-sv
yttre_hölje = yttre+h%C3%B6lje-sv
ytkrackelering = ytkrackelering-sv
ytnivå = ytniv%C3%A5-sv
yttrium-aluminium-granat = yttrium-aluminium-granat-sv
zinkbetmedel = zinkbetmedel-sv
zebramarkering = zebramarkering-sv
yttre_avbrottsbegäran = yttre+avbrottsbeg%C3%A4ran-sv
ytprocess = ytprocess-sv
yrkesutbildningspolitik = yrkesutbildningspolitik-sv
zonlinsantenn = zonlinsantenn-sv
ytregistrering = ytregistrering-sv
yrekstraumatologi = yrekstraumatologi-sv
yttrande_över_erbjudandets_rimlighet = yttrande+%C3%B6ver+erbjudandets+rimlighet-sv
zoonos = zoonos-sv
yttryck_längst_upp_i_ett_annulärt_utrymme = yttryck+l%C3%A4ngst+upp+i+ett+annul%C3%A4rt+utrymme-sv
yttre_vattenkretslopp = yttre+vattenkretslopp-sv
yi = YI-sv
yrkesbetingad_migration = yrkesbetingad+migration-sv
yttre_inspänning = yttre+insp%C3%A4nning-sv
yrkesbetingad_cancer = yrkesbetingad+cancer-sv
zloty = zloty-sv
ymppolymer = ymppolymer-sv
zeranol = zeranol-sv
ziegler-kemi = Ziegler-kemi-sv
yttrandefrihetsmål = yttrandefrihetsm%C3%A5l-sv
yttertandbricka = yttertandbricka-sv
ytterarmslängd = ytterarmsl%C3%A4ngd-sv
zaponlack = zaponlack-sv
ytformtolerans = ytformtolerans-sv
yttre_lager = yttre+lager-sv
yrkesutbildningssektor = yrkesutbildningssektor-sv
yules_q = Yules+Q-sv
zimtaldehyd = zimtaldehyd-sv
yu = YU-sv
yt/volymekvivalent_diameter = yt%2Fvolymekvivalent+diameter-sv
zoogeografi = zoogeografi-sv
ytskrängor = ytskr%C3%A4ngor-sv
ytavspolning = ytavspolning-sv
zona = zona-sv
zinksilikatfärg = zinksilikatf%C3%A4rg-sv
yrkande_om_avskrivning = yrkande+om+avskrivning-sv
ytkällor = ytk%C3%A4llor-sv
yrkesansvar = yrkesansvar-sv
yud = YUD-sv
ytvattenförorening = ytvattenf%C3%B6rorening-sv
zenereffekt = zenereffekt-sv
yankeeobligation = yankeeobligation-sv
ytlinjering = ytlinjering-sv
ytlimmat_papper = ytlimmat+papper-sv
ytterförpackning = ytterf%C3%B6rpackning-sv
ytkondensator = ytkondensator-sv
zar = ZAR-sv
yrkesmedicin = yrkesmedicin-sv
yttre_spänning = yttre+sp%C3%A4nning-sv
ympansvällning = ympansv%C3%A4llning-sv
yrkesmässigt_utsatt_arbetstagare = yrkesm%C3%A4ssigt+utsatt+arbetstagare-sv
zinkhydroxid = zinkhydroxid-sv
zinkstearat = zinkstearat-sv
yttre_induktans = yttre+induktans-sv
yes/mvs = YES%2FMVS-sv
yrkeskunnande = yrkeskunnande-sv
ytbruten_inmatning = ytbruten+inmatning-sv
yttersta_nettokostnad = yttersta+nettokostnad-sv
ytterligare_hyra = ytterligare+hyra-sv
zinkfatalocyaninsulfonat = zinkfatalocyaninsulfonat-sv
ytimpedans = ytimpedans-sv
yttre_egenskap = yttre+egenskap-sv
zirkonopakifiering = zirkonopakifiering-sv
yttre_förstärkning = yttre+f%C3%B6rst%C3%A4rkning-sv
ytterligare_information = ytterligare+information-sv
yttre_kabelinstallation = yttre+kabelinstallation-sv
zinkkromatgrundfärg = zinkkromatgrundf%C3%A4rg-sv
yorkshiregris = yorkshiregris-sv
yttre_noggrannhet = yttre+noggrannhet-sv
yttre_valsspricka = yttre+valsspricka-sv
yrkesinriktad_högskola,_första_stadiet = yrkesinriktad+h%C3%B6gskola%2C+f%C3%B6rsta+stadiet-sv
zuklopentixol = zuklopentixol-sv
yrkeskultur = yrkeskultur-sv
zooteknisk = zooteknisk-sv
yttre_mjukning = yttre+mjukning-sv
yrkesfallenhet = yrkesfallenhet-sv
ytriktig_projektion = ytriktig+projektion-sv
zinkkarbonat = zinkkarbonat-sv
yrken_inom_konsthantverk_och_konstindustri = yrken+inom+konsthantverk+och+konstindustri-sv
yngelutsättning = yngeluts%C3%A4ttning-sv
zoonotisk_sjukdom = zoonotisk+sjukdom-sv
yag-laser = YAG-laser-sv
yrkanden = yrkanden-sv
ytterligare_sektionsminskning = ytterligare+sektionsminskning-sv
yngeldamm = yngeldamm-sv
ytpotentialbarriär = ytpotentialbarri%C3%A4r-sv
yates-grundy_uppskattare = Yates-Grundy+uppskattare-sv
ytuppmjukningstemperatur = ytuppmjukningstemperatur-sv
yrkesmässigt_uppförande = yrkesm%C3%A4ssigt+uppf%C3%B6rande-sv
yrkesinspektionen = Yrkesinspektionen-sv
ytbehandlingsmaterial_för_isolering = ytbehandlingsmaterial+f%C3%B6r+isolering-sv
ytreaktionsstyrning = ytreaktionsstyrning-sv
ytdeponering = ytdeponering-sv
yrkesakne = yrkesakne-sv
yta_med_en_rät_linje_som_generatris = yta+med+en+r%C3%A4t+linje+som+generatris-sv
yrkesrelaterad_leukemi = yrkesrelaterad+leukemi-sv
yttermarginal = yttermarginal-sv
ytbehandling = ytbehandling-sv
ytterhörn_på_takränna = ytterh%C3%B6rn+p%C3%A5+takr%C3%A4nna-sv
ytelement = ytelement-sv
yrkesmässig = yrkesm%C3%A4ssig-sv
yttrande_på_eget_initiativ = yttrande+p%C3%A5+eget+initiativ-sv
ytlig_porositet = ytlig+porositet-sv
ytredistribution_hos_fosfor = ytredistribution+hos+fosfor-sv
yttre_diameter = yttre+diameter-sv
ytvatten_avsett_för_rekreation = ytvatten+avsett+f%C3%B6r+rekreation-sv
ytskada = ytskada-sv
zipeprol = zipeprol-sv
ymppåse = ympp%C3%A5se-sv
ytterfilé = ytterfil%C3%A9-sv
ytojämnheter_på_kristallytan = ytoj%C3%A4mnheter+p%C3%A5+kristallytan-sv
ytantigen = ytantigen-sv
ytskikt = ytskikt-sv
ytmyllning/öppen_skåra = ytmyllning%2F%C3%B6ppen+sk%C3%A5ra-sv
ytråhetstal = ytr%C3%A5hetstal-sv
ytans_refraktionsindex = ytans+refraktionsindex-sv
y-anslutning = Y-anslutning-sv
z-fyrpolsparameter = z-fyrpolsparameter-sv
yrkesman = yrkesman-sv
ytmodell = ytmodell-sv
yorkshire-fett = Yorkshire-fett-sv
zinkblände = zinkbl%C3%A4nde-sv
zonindelning = zonindelning-sv
zenerkarakteristik = zenerkarakteristik-sv
yrkande_inlaga = yrkande+inlaga-sv
zoonotisk_agens = zoonotisk+agens-sv
ympad_vinranka = ympad+vinranka-sv
ylem = ylem-sv
yttrandeakt = yttrandeakt-sv
yrkande_om_hänvisning_till_annan_domstol = yrkande+om+h%C3%A4nvisning+till+annan+domstol-sv
yules_ekvation = Yules+ekvation-sv
ytterbeklädnad = ytterbekl%C3%A4dnad-sv
yrkande_i_första_hand = yrkande+i+f%C3%B6rsta+hand-sv
zink-luftcell = zink-luftcell-sv
zenergenombrott = zenergenombrott-sv
yttre_avfrostning = yttre+avfrostning-sv
ytmodellering = ytmodellering-sv
ympkompatibilitet = ympkompatibilitet-sv
yl-värde = YL-v%C3%A4rde-sv
zimidoben = zimidoben-sv
zenitfotografering = zenitfotografering-sv
zon_med_omvänd_ils-visning = zon+med+omv%C3%A4nd+ILS-visning-sv
yorkshiresvin = yorkshiresvin-sv
ytporositet = ytporositet-sv
ytbehandlat_gödselmedel = ytbehandlat+g%C3%B6dselmedel-sv
ytblåsor = ytbl%C3%A5sor-sv
yttre_kylring = yttre+kylring-sv
zebra = ZEBRA-sv
yttervinge = yttervinge-sv
ytrelaterad_behandlingshastighet = ytrelaterad+behandlingshastighet-sv
ytkunskap = ytkunskap-sv
yngelträd = yngeltr%C3%A4d-sv
ytdränering = ytdr%C3%A4nering-sv
zonerat = zonerat-sv
zoogleafilm = zoogleafilm-sv
yttrandefrihetsbrott = yttrandefrihetsbrott-sv
yttrande_i_vilket_ett_avtal_bedöms_vara_oförenligt_med_bestämmelserna_i_fördraget = yttrande+i+vilket+ett+avtal+bed%C3%B6ms+vara+of%C3%B6renligt+med+best%C3%A4mmelserna+i+f%C3%B6rdraget-sv
yttre_bromsstrålning = yttre+bromsstr%C3%A5lning-sv
yttre_överspänning = yttre+%C3%B6versp%C3%A4nning-sv
yrkesutbildning = yrkesutbildning-sv
yen = yen-sv
ytmärke = ytm%C3%A4rke-sv
yrkesmässiga_privilegier = yrkesm%C3%A4ssiga+privilegier-sv
yrkande_i_andra_hand = yrkande+i+andra+hand-sv
yrkesbetingad_hudcancer = yrkesbetingad+hudcancer-sv
yrkesinspektion = yrkesinspektion-sv
ytpor = ytpor-sv
yule-fördelning = Yule-f%C3%B6rdelning-sv
y-koppling = Y-koppling-sv
yta_med_invers_segring = yta+med+invers+segring-sv
yttre_inversionsskikt = yttre+inversionsskikt-sv
yrkesmässig_distribution_och_användning_av_giftiga_ämnen = yrkesm%C3%A4ssig+distribution+och+anv%C3%A4ndning+av+giftiga+%C3%A4mnen-sv
ytimplantat = ytimplantat-sv
ytprognoskarta = ytprognoskarta-sv
yrkesrelationer = yrkesrelationer-sv
ytverkan = ytverkan-sv
zyglo-test = Zyglo-test-sv
yttervägg = ytterv%C3%A4gg-sv
ythållfasthet = yth%C3%A5llfasthet-sv
ytterområde = ytteromr%C3%A5de-sv
ytterkord = ytterkord-sv
zaldarid = zaldarid-sv
zolertin = zolertin-sv
zon = zon-sv
zoologi = zoologi-sv
zalcitabin = zalcitabin-sv
yttäckning = ytt%C3%A4ckning-sv
yrkesmässig_utbildning_av_franchisetagare = yrkesm%C3%A4ssig+utbildning+av+franchisetagare-sv
yug = YUG-sv
zinkglasyr = zinkglasyr-sv
yttre_kännetecken = yttre+k%C3%A4nnetecken-sv
ytskum = ytskum-sv
yttranden_givna_/_gett_yttranden = yttranden+givna+%2F+gett+yttranden-sv
yrkeseksem_hos_damfrisörskor = yrkeseksem+hos+damfris%C3%B6rskor-sv
yachtförsäkring = yachtf%C3%B6rs%C3%A4kring-sv
yttre_kapacitans = yttre+kapacitans-sv
ytkontaminationsmätare = ytkontaminationsm%C3%A4tare-sv
ytvikt = ytvikt-sv
zr = ZR-sv
ytglans = ytglans-sv
yrke_inom_lantbruket = yrke+inom+lantbruket-sv
ytlångrevsfartyg = ytl%C3%A5ngrevsfartyg-sv
yttre_mjukningsmedel = yttre+mjukningsmedel-sv
zoomat_fönster = zoomat+f%C3%B6nster-sv
yrkesutbildad_arbetare = yrkesutbildad+arbetare-sv
yorkshire-appretering = Yorkshire-appretering-sv
zymogen = zymogen-sv
ytterligare_sätt_att_uppfylla_kraven = ytterligare+s%C3%A4tt+att+uppfylla+kraven-sv
yta_på_landningsklaff = yta+p%C3%A5+landningsklaff-sv
za_1926 = ZA+1926-sv
yngelkorg = yngelkorg-sv
ytterligare_provstycke = ytterligare+provstycke-sv
yrkesverksamhet = yrkesverksamhet-sv
ympdosering = ympdosering-sv
yrkesbetingad_callus = yrkesbetingad+callus-sv
yttäckande_trafikering = ytt%C3%A4ckande+trafikering-sv
zenerspänning = zenersp%C3%A4nning-sv
zoonotisk_bakterie = zoonotisk+bakterie-sv
yrkeshierarki = yrkeshierarki-sv
zonografi = zonografi-sv
zoninjektering = zoninjektering-sv
zoomkodare = zoomkodare-sv
ytskikt_i_laminat = ytskikt+i+laminat-sv
zidovudin = zidovudin-sv
ytcentrerat_kubiskt_gitter = ytcentrerat+kubiskt+gitter-sv
yrkesepidemiologi = yrkesepidemiologi-sv
yttre_hörn = yttre+h%C3%B6rn-sv
yttre_förpackning = yttre+f%C3%B6rpackning-sv
zontaxa = zontaxa-sv
ytjämnhetsmätare = ytj%C3%A4mnhetsm%C3%A4tare-sv
zinksulfid = zinksulfid-sv
ytterslitsad_solfjäderbricka = ytterslitsad+solfj%C3%A4derbricka-sv
yrkeshåg = yrkesh%C3%A5g-sv
ytbehandlingslinje = ytbehandlingslinje-sv
ytdefekt = ytdefekt-sv
yttre_markeringsfyr = yttre+markeringsfyr-sv
yturval = yturval-sv
ytlig_dränering = ytlig+dr%C3%A4nering-sv
zofenopril = zofenopril-sv
ytmatta = ytmatta-sv
zucchini,_squash,_pumpor = zucchini%2C+squash%2C+pumpor-sv
ytterligare_bränsle = ytterligare+br%C3%A4nsle-sv
ytjämnhet = ytj%C3%A4mnhet-sv
yrkespraxis = yrkespraxis-sv
ythastighet = ythastighet-sv
yrkesbetingad_tuberkulos = yrkesbetingad+tuberkulos-sv
zonal_jordmån = zonal+jordm%C3%A5n-sv
ytpersonal = ytpersonal-sv
yagi-antenn = Yagi-antenn-sv
yt-fälteffekttransistor = yt-f%C3%A4lteffekttransistor-sv
ytråhetskoefficient = ytr%C3%A5hetskoefficient-sv
ytkällemätning = ytk%C3%A4llem%C3%A4tning-sv
yrkeskunnig_person = yrkeskunnig+person-sv
zoo = zoo-sv
ytvattenstatus = ytvattenstatus-sv
zonindelat_trafiksystem = zonindelat+trafiksystem-sv
yrkesmässig_degradering = yrkesm%C3%A4ssig+degradering-sv
ytnyttiggörande = ytnyttigg%C3%B6rande-sv
zambia = Zambia-sv
z-koppling = Z-koppling-sv
zopiklon = zopiklon-sv
ytemitterande_lysdiod = ytemitterande+lysdiod-sv
yttre_spiralformad_ledare = yttre+spiralformad+ledare-sv
zooteknisk_tillsats = zooteknisk+tillsats-sv
yrkesvägledare = yrkesv%C3%A4gledare-sv
ydd = YDD-sv
ytkonduktans = ytkonduktans-sv
yrkessjukdom = yrkessjukdom-sv
zibeline = zibeline-sv
zoommotor = zoommotor-sv
ympjäst = ympj%C3%A4st-sv
ytaktiva_tillsatser_i_motorolja = ytaktiva+tillsatser+i+motorolja-sv
y-cirkulator = Y-cirkulator-sv
yankee_system = Yankee+system-sv
ytterligare_dokumentation = ytterligare+dokumentation-sv
yrkande_om_företräde = yrkande+om+f%C3%B6retr%C3%A4de-sv
ytprofil = ytprofil-sv
ytmyllningsaggregat = ytmyllningsaggregat-sv
ytkälla = ytk%C3%A4lla-sv
ytmanifestationer = ytmanifestationer-sv
yttre_effekt = yttre+effekt-sv
yttre_konvexsida_av_valvbygge = yttre+konvexsida+av+valvbygge-sv
ytterytans_rundningsradie = ytterytans+rundningsradie-sv
zampone = zampone-sv
ytsådd = yts%C3%A5dd-sv
yttre_förbindelser = yttre+f%C3%B6rbindelser-sv
ytterligare_egna_medel = ytterligare+egna+medel-sv
ytutarmningsskikt = ytutarmningsskikt-sv
ympning_på_äldre_ved = ympning+p%C3%A5+%C3%A4ldre+ved-sv
ythårdhetens_likformighet = yth%C3%A5rdhetens+likformighet-sv
y = Y-sv
yrkesutbildningsorgan = yrkesutbildningsorgan-sv
yrkesintroduktion = yrkesintroduktion-sv
ytförgasare = ytf%C3%B6rgasare-sv
yttertemperaturmätare = yttertemperaturm%C3%A4tare-sv
zinkgult = zinkgult-sv
y2b = Y2B-sv
ytprägling = ytpr%C3%A4gling-sv
zinostatin = zinostatin-sv
yrkande_om_interimistiskt_beslut = yrkande+om+interimistiskt+beslut-sv
ytterrundslipning = ytterrundslipning-sv
ytvåg = ytv%C3%A5g-sv
ytförångning = ytf%C3%B6r%C3%A5ngning-sv
younkins_metod = Younkins+metod-sv
zenitteleskop = zenitteleskop-sv
zonsmältningsprocess = zonsm%C3%A4ltningsprocess-sv
yrkesmässiga_företrädare = yrkesm%C3%A4ssiga+f%C3%B6retr%C3%A4dare-sv
z-bladsblandare = Z-bladsblandare-sv
zilaskorb_(2_h) = zilaskorb+%282+H%29-sv
yttriumjärnkristall = yttriumj%C3%A4rnkristall-sv
yrkeskurs = yrkeskurs-sv
yttrande_vid_första_behandlingen = yttrande+vid+f%C3%B6rsta+behandlingen-sv
ytintegral = ytintegral-sv
yta_angripen_av_gropfrätning = yta+angripen+av+gropfr%C3%A4tning-sv
ystmjölk = ystmj%C3%B6lk-sv
yttre_register = yttre+register-sv
ytjämnhetslikare = ytj%C3%A4mnhetslikare-sv
ytgenombrott = ytgenombrott-sv
ytsökningsradar = yts%C3%B6kningsradar-sv
zmk = ZMK-sv
yrkeskompetens = yrkeskompetens-sv
ytavskumning = ytavskumning-sv
yrken_i_bygg-och_anläggningsverksamhet = yrken+i+bygg-och+anl%C3%A4ggningsverksamhet-sv
yttranden_som_antas_enligt_det_centraliserade_förfarandet = yttranden+som+antas+enligt+det+centraliserade+f%C3%B6rfarandet-sv
zenerformel = zenerformel-sv
yrkesutbildning_inom_handel = yrkesutbildning+inom+handel-sv
yrkande = yrkande-sv
zeaxantin = zeaxantin-sv
ytfriktionsmotstånd = ytfriktionsmotst%C3%A5nd-sv
yttre_drag = yttre+drag-sv
ylande_förbränning = ylande+f%C3%B6rbr%C3%A4nning-sv
yttertak = yttertak-sv
ytprov = ytprov-sv
yttre_elektronkanon = yttre+elektronkanon-sv
yrkesinternational = yrkesinternational-sv
yttrandefrihetsgrundlagen = yttrandefrihetsgrundlagen-sv
yrkeskodex = yrkeskodex-sv
ytterdörr = ytterd%C3%B6rr-sv
ytmigreringsinstabilitet = ytmigreringsinstabilitet-sv
zenitvinkel = zenitvinkel-sv
zygotens_fastväxande_i_livmodern = zygotens+fastv%C3%A4xande+i+livmodern-sv
yrkesinspektörskommittén = yrkesinspekt%C3%B6rskommitt%C3%A9n-sv
zooplanktons_biomassa = zooplanktons+biomassa-sv
ytligt_åkerbruk = ytligt+%C3%A5kerbruk-sv
yrkesskola = yrkesskola-sv
yaren = Yaren-sv
yer = YER-sv
zokainon = zokainon-sv
ytmönstrets_orientering = ytm%C3%B6nstrets+orientering-sv
zonsmältning = zonsm%C3%A4ltning-sv
yrkesmässigt_förhållningssätt = yrkesm%C3%A4ssigt+f%C3%B6rh%C3%A5llningss%C3%A4tt-sv
ytbevattning_genom_översilning = ytbevattning+genom+%C3%B6versilning-sv
zonuppdelning = zonuppdelning-sv
yrkesutveckling_i_arbetet = yrkesutveckling+i+arbetet-sv
zilantel = zilantel-sv
yrka_tredskodom = yrka+tredskodom-sv
yttersta_randområden = yttersta+randomr%C3%A5den-sv
ympad_förpackning = ympad+f%C3%B6rpackning-sv
zinkgrått = zinkgr%C3%A5tt-sv
ytutseende = ytutseende-sv
yrkesmässigt_ansvar = yrkesm%C3%A4ssigt+ansvar-sv
zinkplåt = zinkpl%C3%A5t-sv
yokto = yokto-sv
ytkatod = ytkatod-sv
ytavfuktare = ytavfuktare-sv
zawafa = zawafa-sv
z-komposant = Z-komposant-sv
zinokonazol = zinokonazol-sv
z-fördelning = z-f%C3%B6rdelning-sv
zanamivir = zanamivir-sv
z-markeringsfyr = Z-markeringsfyr-sv
ytråhet = ytr%C3%A5het-sv
ytterligare_minsta_insats = ytterligare+minsta+insats-sv
yttre_konturtank = yttre+konturtank-sv
ytlig_likhetsrelation = ytlig+likhetsrelation-sv
zimbabwe = Zimbabwe-sv
yrkeselit = yrkeselit-sv
yttolerans = yttolerans-sv
zrz = ZRZ-sv
ytmycel = ytmycel-sv
ytsvetslödning = ytsvetsl%C3%B6dning-sv
zon_med_partiell_avkolning = zon+med+partiell+avkolning-sv
yttransport = yttransport-sv
z-parametrar = z-parametrar-sv
zoltais_klassificering = Zoltais+klassificering-sv
ytvatten = ytvatten-sv
yrkeshemlighet = yrkeshemlighet-sv
zoologisk_trädgård;_djurpark = zoologisk+tr%C3%A4dg%C3%A5rd%3B+djurpark-sv
yermosol = yermosol-sv
zearalenon = zearalenon-sv
zink = zink-sv
zetapotential = zetapotential-sv
yrkesetisk_kodex = yrkesetisk+kodex-sv
ytfunktionalisering = ytfunktionalisering-sv
zankiren = zankiren-sv
