wef = WEF-sv
wallichs_fasan = Wallichs+fasan-sv
w-struktur = w-struktur-sv
wai = WAI-sv
whittle-fördelning = Whittle-f%C3%B6rdelning-sv
workaround = workaround-sv
x = X-sv
wwan = WWAN-sv
wto = WTO-sv
wallflower = wallflower-sv
weag-panel = WEAG-panel-sv
xantangummi = xantangummi-sv
x-y-skrivare = x-y-skrivare-sv
ximoprofen = ximoprofen-sv
whitworthgänga = whitworthg%C3%A4nga-sv
who = WHO-sv
w-statistika = W-statistika-sv
xylenekvivalent = xylenekvivalent-sv
winpad = Winpad-sv
webbläsarprogram = webbl%C3%A4sarprogram-sv
wbcsd = WBCSD-sv
wfp_iefr = WFP+IEFR-sv
whole_account_treaty = whole+account+treaty-sv
xml = XML-sv
watt_per_kilogram = watt+per+kilogram-sv
walesiska = walesiska-sv
x-systemprotokoll = x-systemprotokoll-sv
wbsarc = WBSARC-sv
wiener-hopf-tekniken = Wiener-Hopf-tekniken-sv
wto-avtalet = WTO-avtalet-sv
x-motor = X-motor-sv
wanderhaufen = Wanderhaufen-sv
xaliproden = xaliproden-sv
wisers_metod = Wisers+metod-sv
xerga = xerga-sv
willy-willy = willy-willy-sv
www = WWW-sv
whistlervågor = Whistlerv%C3%A5gor-sv
wto:s_allmänna_råd = WTO%3As+allm%C3%A4nna+r%C3%A5d-sv
watchdog_timer = watchdog+timer-sv
whirlpoolseparering = whirlpoolseparering-sv
webb = webb-sv
wfp_pro = WFP+PRO-sv
xinidamin = xinidamin-sv
xanoxsyra = xanoxsyra-sv
world_administrative_radio_conferences = World+Administrative+Radio+Conferences-sv
white_box-testning = white+box-testning-sv
xenobiotiskt_ämne = xenobiotiskt+%C3%A4mne-sv
xantofyll = xantofyll-sv
wpc_system = WPC+system-sv
xof = XOF-sv
wto:s_varuhandelsråd = WTO%3As+varuhandelsr%C3%A5d-sv
xyloxemin = xyloxemin-sv
xylotrios = xylotrios-sv
warszawa = Warszawa-sv
wheatstone-system = Wheatstone-system-sv
xylamidintosilat = xylamidintosilat-sv
whistlervåg = Whistlerv%C3%A5g-sv
x.121-adress = X.121-adress-sv
wipos_fördrag_om_framföranden_och_fonogram = Wipos+f%C3%B6rdrag+om+framf%C3%B6randen+och+fonogram-sv
x-klient = x-klient-sv
x-,y-,z-,... = x-%2Cy-%2Cz-%2C...-sv
wattimmätare = wattimm%C3%A4tare-sv
wolds_markovprocess_av_intervall = Wolds+Markovprocess+av+intervall-sv
wald-wolfowitz_runtest = Wald-Wolfowitz+runtest-sv
world_broadcasting_satellite_administrative_radio_conference = World+Broadcasting+Satellite+Administrative+Radio+Conference-sv
willis_fenomen = Willis+fenomen-sv
wigner-nuklider = Wigner-nuklider-sv
xantofylpalmitat = xantofylpalmitat-sv
wheatstone-brygga = Wheatstone-brygga-sv
wltc = WLTC-sv
wake-on-lan = wake-on-lan-sv
wegeners_granulomatos = Wegeners+granulomatos-sv
webbtillgänglighet = webbtillg%C3%A4nglighet-sv
weao = WEAO-sv
weissbier = Weissbier-sv
we = We-sv
wincey = wincey-sv
woods_lampa = Woods+lampa-sv
wacc = WACC-sv
wink_start = wink+start-sv
wiganfinish = wiganfinish-sv
wöhlerdiagram = W%C3%B6hlerdiagram-sv
wipo = Wipo-sv
walds_klassifikationsstatistika = Walds+klassifikationsstatistika-sv
wienkonventionen_om_traktaträtten_mellan_stater_och_internationella_organisationer_eller_internationella_organisationer_sinsemellan = Wienkonventionen+om+traktatr%C3%A4tten+mellan+stater+och+internationella+organisationer+eller+internationella+organisationer+sinsemellan-sv
walkie-talkie = walkie-talkie-sv
webbmästare = webbm%C3%A4stare-sv
xmodem-protokoll = Xmodem-protokoll-sv
world_wide_web = World+Wide+Web-sv
walter-lieths_klimatdiagram = Walter-Lieths+klimatdiagram-sv
x.410-1984-mod = X.410-1984-mod-sv
waterbed-effekt = waterbed-effekt-sv
wct = WCT-sv
wallis_och_futuna = Wallis+och+Futuna-sv
watt_per_kanal = watt+per+kanal-sv
x-tillämpning = x-till%C3%A4mpning-sv
wipos_diplomatkonferens_om_skydd_av_audiovisuella_framträdanden = Wipos+diplomatkonferens+om+skydd+av+audiovisuella+framtr%C3%A4danden-sv
whipped_topping = whipped+topping-sv
wagr-test = WAGR-test-sv
wien = Wien-sv
wilking = wilking-sv
xerotin = xerotin-sv
wheatstonebrygga = Wheatstonebrygga-sv
wallnerlinjer = Wallnerlinjer-sv
wienkonventionen_om_konsulära_förbindelser = Wienkonventionen+om+konsul%C3%A4ra+f%C3%B6rbindelser-sv
wfp = WFP-sv
wiresvep = wiresvep-sv
xenytropiumbromid = xenytropiumbromid-sv
wb = Wb-sv
webbserver = webbserver-sv
xamoterol = xamoterol-sv
xenoneffekt = xenoneffekt-sv
wellpapp = wellpapp-sv
winstonkoncentrator = Winstonkoncentrator-sv
webbtjänstgränssnitt = webbtj%C3%A4nstgr%C3%A4nssnitt-sv
white_hat = white+hat-sv
warszawakonventionen = Warszawakonventionen-sv
wilms_tumör = Wilms+tum%C3%B6r-sv
x-tillämpningsgränssnitt = x-till%C3%A4mpningsgr%C3%A4nssnitt-sv
webbmejl = webbmejl-sv
welmms_metodik_för_resursanalys = WELMMs+metodik+f%C3%B6r+resursanalys-sv
well-pointpump = well-pointpump-sv
with-sats = with-sats-sv
webbadress = webbadress-sv
wcl = WCL-sv
wellpappråvaror = wellpappr%C3%A5varor-sv
wqi-index = WQI-index-sv
wireless_callnote = wireless+callnote-sv
wto:s_överprövningsorgan = WTO%3As+%C3%B6verpr%C3%B6vningsorgan-sv
wiener-khintchine-sats = Wiener-Khintchine-sats-sv
wada = Wada-sv
webbutsändning_av_rådets_presskonferens = webbuts%C3%A4ndning+av+r%C3%A5dets+presskonferens-sv
w-motor = W-motor-sv
wiskott-aldrichs_syndrom = Wiskott-Aldrichs+syndrom-sv
x.25_pad = X.25+PAD-sv
waferprovning = waferprovning-sv
webblogg = webblogg-sv
xdp-u50d-kompatibel = XDP-U50D-kompatibel-sv
wrs-oxidationsprocess = WRS-oxidationsprocess-sv
watt_toppeffekt = watt+toppeffekt-sv
wilkensoncombiner = Wilkensoncombiner-sv
wenra = Wenra-sv
x-skuren_kristall = X-skuren+kristall-sv
wirestagad_mast = wirestagad+mast-sv
ward-leonard-system = Ward-Leonard-system-sv
wan = WAN-sv
wafer_scale_integration = wafer+scale+integration-sv
wfp:s_styrelse = WFP%3As+styrelse-sv
xenogen_2)heterogen = xenogen+2%29heterogen-sv
wifi4eu = WiFi4EU-sv
xenolit = xenolit-sv
willowsidläder = willowsidl%C3%A4der-sv
wp = WP-sv
wilkinsons_processionsspinnare = Wilkinsons+processionsspinnare-sv
x-open = x-open-sv
webbläsare = webbl%C3%A4sare-sv
whitworths_grovgänga = Whitworths+grovg%C3%A4nga-sv
wolds_upplösningssats = Wolds+uppl%C3%B6sningssats-sv
warfarin = warfarin-sv
xylan = xylan-sv
wiendeklarationen = Wiendeklarationen-sv
wattlös_effekt = wattl%C3%B6s+effekt-sv
w/m2 = W%2Fm2-sv
wcd = WCD-sv
wecpnl-nivå = WECPNL-niv%C3%A5-sv
wuchangbraxen = wuchangbraxen-sv
w-vinge = W-vinge-sv
warrant = warrant-sv
wltp = WLTP-sv
wellington = Wellington-sv
werdnig-hoffmanns_sjukdom = Werdnig-Hoffmanns+sjukdom-sv
wienkonventionen_för_skydd_av_ozonlagret = Wienkonventionen+f%C3%B6r+skydd+av+ozonlagret-sv
x-tjänstdefinition = x-tj%C3%A4nstdefinition-sv
wavaw = Wavaw-sv
xenipenton = xenipenton-sv
whistleblowing = whistleblowing-sv
xerotermisk = xerotermisk-sv
wsi = WSI-sv
xibenolol = xibenolol-sv
weymouthtall = weymouthtall-sv
williams_plastometer = Williams+plastometer-sv
willemstad = Willemstad-sv
wsis = WSIS-sv
world_business_council_for_sustainable_development = World+Business+Council+for+Sustainable+Development-sv
west-gaeks_metod = West-Gaeks+metod-sv
winglet = winglet-sv
wmo = WMO-sv
x-länk = X-l%C3%A4nk-sv
xenazoinsyra = xenazoinsyra-sv
woodbury-fördelning = Woodbury-f%C3%B6rdelning-sv
wano = WANO-sv
wiendeklarationen_och_-handlingsprogrammet = Wiendeklarationen+och+-handlingsprogrammet-sv
weils_sjukdom = Weils+sjukdom-sv
wssv = WSSV-sv
westamaran = westamaran-sv
wide-body-flygplan = wide-body-flygplan-sv
windhoek = Windhoek-sv
wolfsbergsprinciperna_för_bekämpning_av_penningtvätt = Wolfsbergsprinciperna+f%C3%B6r+bek%C3%A4mpning+av+penningtv%C3%A4tt-sv
witloofcikoria = witloofcikoria-sv
wppt = WPPT-sv
wcc = WCC-sv
webbplattform_för_vuxenutbildning_i_europa = webbplattform+f%C3%B6r+vuxenutbildning+i+Europa-sv
wilcoxon_mann-whitney-test = Wilcoxon+Mann-Whitney-test-sv
x.25-port = X.25-port-sv
wedge_bond = wedge+bond-sv
world_wide_web_consortium = World+Wide+Web+Consortium-sv
whiskers = whiskers-sv
wilks-lawleys_u1-statistika = Wilks-Lawleys+U1-statistika-sv
xantiol = xantiol-sv
wracs = WRACS-sv
walkaway-klausul = walkaway-klausul-sv
xenbucin = xenbucin-sv
xantocillin = xantocillin-sv
weber = weber-sv
workover = workover-sv
xor-krets = XOR-krets-sv
wd = WD-sv
widrow-hoffs_regel = Widrow-Hoffs+regel-sv
wattmeter = wattmeter-sv
widmanstättenstruktur = Widmanst%C3%A4ttenstruktur-sv
wrocław = Wroc%C5%82aw-sv
wkb-lösning = WKB-l%C3%B6sning-sv
wilson-hilferty-transformation = Wilson-Hilferty-transformation-sv
watt_per_kvadratmeter = watt+per+kvadratmeter-sv
w2n-test = W2N-test-sv
xylostrom = xylostrom-sv
waldeyers_svalgring = Waldeyers+svalgring-sv
whirlpool = whirlpool-sv
xy-skrivare = XY-skrivare-sv
wienkonventionen_om_diplomatiska_förbindelser = Wienkonventionen+om+diplomatiska+f%C3%B6rbindelser-sv
warrants = warrants-sv
xylos = xylos-sv
xemilofiban = xemilofiban-sv
wenner-konfiguration = Wenner-konfiguration-sv
xenotransplantation = xenotransplantation-sv
wbgt = WBGT-sv
wireless_application_protocol = wireless+application+protocol-sv
willstätter-lignin = Willst%C3%A4tter-lignin-sv
wwf = WWF-sv
watt = watt-sv
wiki = wiki-sv
williams-domän = Williams-dom%C3%A4n-sv
windfall_profit = windfall+profit-sv
wattimme-verkningsgrad = wattimme-verkningsgrad-sv
williams-beurens_syndrom = Williams-Beurens+syndrom-sv
wt = Wt-sv
wevenit = wevenit-sv
willison-koppel = Willison-koppel-sv
w/kg = W%2Fkg-sv
woodruffkil = woodruffkil-sv
winsoriserad_uppskattning = Winsoriserad+uppskattning-sv
xyloporos = xyloporos-sv
wellhead-tryck = wellhead-tryck-sv
wigan = wigan-sv
xfp = XFP-sv
xanthofyll = xanthofyll-sv
xerofytiska_gräs = xerofytiska+gr%C3%A4s-sv
xbrl = XBRL-sv
xenonbåglampa = xenonb%C3%A5glampa-sv
xeromorfi = xeromorfi-sv
wobbetal = Wobbetal-sv
xibornol = xibornol-sv
xenobiotikum = xenobiotikum-sv
xenogam = xenogam-sv
xantofyller = xantofyller-sv
weimartriangeln = Weimartriangeln-sv
xylidin = xylidin-sv
x-låsning = X-l%C3%A5sning-sv
xylazin = xylazin-sv
walter_reed-klassifikation = Walter+Reed-klassifikation-sv
wollastonit = wollastonit-sv
watsons_u2n-test = Watsons+U2N-test-sv
weathering = weathering-sv
wigner-utlösning = Wigner-utl%C3%B6sning-sv
x-ring = X-ring-sv
xsd = xsd-sv
wedge_bonding = wedge+bonding-sv
x-band = X-band-sv
watson-williams_test = Watson-Williams+test-sv
whole-body-resonansfrekvens = whole-body-resonansfrekvens-sv
xantinoxidas = xantinoxidas-sv
wigner-kraft = Wigner-kraft-sv
wide-screen-skärm = wide-screen-sk%C3%A4rm-sv
xenysalat = xenysalat-sv
wolfowitz_minsta_avstånds_metod = Wolfowitz+minsta+avst%C3%A5nds+metod-sv
wingers_metod = Wingers+metod-sv
weag = WEAG-sv
x-parallax = x-parallax-sv
warszawadeklarationen = Warszawadeklarationen-sv
xenihexensyra = xenihexensyra-sv
x.25-rekommendation = X.25-rekommendation-sv
xanomelin = xanomelin-sv
x.25-switch = X.25-switch-sv
whitings_motviktssystem = Whitings+motviktssystem-sv
xantoproteinreaktion = xantoproteinreaktion-sv
wto:s_ställning = WTO%3As+st%C3%A4llning-sv
wilson-kammare = Wilson-kammare-sv
wolffska_gångar = Wolffska+g%C3%A5ngar-sv
xylometazolin = xylometazolin-sv
way-point = way-point-sv
webbutgivning = webbutgivning-sv
xipamid = xipamid-sv
woods_glas = Woods+glas-sv
xenical = Xenical-sv
wengé = weng%C3%A9-sv
wco = WCO-sv
wilkensonsplitter = Wilkensonsplitter-sv
wienkonventionen_om_staters_representation_i_deras_förbindelser_med_internationella_organisationer_av_universell_karaktär = Wienkonventionen+om+staters+representation+i+deras+f%C3%B6rbindelser+med+internationella+organisationer+av+universell+karakt%C3%A4r-sv
wishart-fördelning = Wishart-f%C3%B6rdelning-sv
wap = wap-sv
www = www-sv
western_equine_encephalomyelitis = western+equine+encephalomyelitis-sv
x-windows = X-windows-sv
while-instruktion = WHILE-instruktion-sv
weimar = Weimar-sv
washington_dc = Washington+DC-sv
ward-leonardomformare = Ward-Leonardomformare-sv
w-index = W-index-sv
workshop = workshop-sv
wnis = WNIS-sv
xg-antikropp = Xg-antikropp-sv
wilde-klassificering = Wilde-klassificering-sv
written_line = written+line-sv
xorfanol = xorfanol-sv
xenon = xenon-sv
xylanas = xylanas-sv
who-teq = WHO-TEQ-sv
wirespänningsregulatorer = wiresp%C3%A4nningsregulatorer-sv
wahoo = wahoo-sv
xenonlampa = xenonlampa-sv
webbansvarig = webbansvarig-sv
xylen = xylen-sv
wassenaar-arrangemanget = Wassenaar-arrangemanget-sv
wmo-kongressen = WMO-kongressen-sv
waldenströms_makroglobulinemi = Waldenstr%C3%B6ms+makroglobulinemi-sv
wafer = wafer-sv
x_sar = X+SAR-sv
wardialer = wardialer-sv
who:s_samarbetscentrum_för_övervakning_av_och_forskning_om_rabies = WHO%3As+samarbetscentrum+f%C3%B6r+%C3%B6vervakning+av+och+forskning+om+rabies-sv
xeroftalmi = xeroftalmi-sv
wienkonventionen_om_statssuccession_såvitt_avser_traktater = Wienkonventionen+om+statssuccession+s%C3%A5vitt+avser+traktater-sv
wheatstones_brygga = Wheatstones+brygga-sv
wingover = wingover-sv
xerodema_pigmentosum = Xerodema+pigmentosum-sv
wagnerbalk = Wagnerbalk-sv
xdsl = xDSL-sv
working_cover = working+cover-sv
waaler-rose-test = Waaler-Rose-test-sv
wira = wira-sv
witney-filt = witney-filt-sv
wurtzitstruktur = wurtzitstruktur-sv
webbcrawler = webbcrawler-sv
w3c = W3C-sv
wlan = WLAN-sv
xantifibrat = xantifibrat-sv
westfalia-metoden = Westfalia-metoden-sv
western_hemlock = western+hemlock-sv
wilcoxon-test = Wilcoxon-test-sv
worst-case-testning = worst-case-testning-sv
webbsida = webbsida-sv
xerografi = xerografi-sv
wilks_tomma_celltest = Wilks+tomma+celltest-sv
wae = WAE-sv
westphals_våg = Westphals+v%C3%A5g-sv
whitbys_aerosolanalysator = Whitbys+aerosolanalysator-sv
working_name = working+name-sv
xenosaurer = xenosaurer-sv
wipo-fördraget_om_upphovsrätt = WIPO-f%C3%B6rdraget+om+upphovsr%C3%A4tt-sv
whittakers_periodogram = Whittakers+periodogram-sv
wadas_stiftelsestyrelse = Wadas+stiftelsestyrelse-sv
whistlervågsinstabilitet = whistlerv%C3%A5gsinstabilitet-sv
western_blot-analys = Western+blot-analys-sv
x-lås = X-l%C3%A5s-sv
wadi = wadi-sv
wassenaar-arrangemanget_om_kontroll_av_export_av_konventionella_vapen_och_varor_och_teknik_med_dubbla_användningsområden = Wassenaar-arrangemanget+om+kontroll+av+export+av+konventionella+vapen+och+varor+och+teknik+med+dubbla+anv%C3%A4ndningsomr%C3%A5den-sv
widmannstättenstruktur = widmannst%C3%A4ttenstruktur-sv
whipcord = whipcord-sv
wet_blue-läder = wet+blue-l%C3%A4der-sv
webbsändning = webbs%C3%A4ndning-sv
xylemmodercell = xylemmodercell-sv
weston-normalcell = Weston-normalcell-sv
warren-stålfackverk = Warren-st%C3%A5lfackverk-sv
wri = WRI-sv
wet_look = wet+look-sv
waaler-roses_test = Waaler-Roses+test-sv
wolframmolybdatpigment = wolframmolybdatpigment-sv
wacquant-klassificering = Wacquant-klassificering-sv
wienkonferens_om_handel_med_kvinnor = Wienkonferens+om+handel+med+kvinnor-sv
xeu = XEU-sv
wiring_closet = wiring+closet-sv
wfc = WFC-sv
wolds_dekomposition = Wolds+dekomposition-sv
wash-and-wearprov = wash-and-wearprov-sv
wavar-åtkomst = WAVAR-%C3%A5tkomst-sv
wadem = WADEM-sv
western_blotting = Western+blotting-sv
xantinolnikotinat = xantinolnikotinat-sv
walker-sannolikhetsfunktion = Walker-sannolikhetsfunktion-sv
wst = WST-sv
xpf = XPF-sv
wee = WEE-sv
wald-fördelning = Wald-f%C3%B6rdelning-sv
xylokumarol = xylokumarol-sv
wto:s_ministerkonferens = WTO%3As+ministerkonferens-sv
webbskrapning = webbskrapning-sv
wrights_stigkoefficientmetod = Wrights+stigkoefficientmetod-sv
webbinsamling = webbinsamling-sv
winceyette = winceyette-sv
xtc = XTC-sv
xerofil_mikroorganism = xerofil+mikroorganism-sv
whitworth-rörgänga = whitworth-r%C3%B6rg%C3%A4nga-sv
w = W-sv
wienkonventionen_för_skydd_av_ozonskiktet = Wienkonventionen+f%C3%B6r+skydd+av+ozonskiktet-sv
wipos_fördrag_om_upphovsrätt = Wipos+f%C3%B6rdrag+om+upphovsr%C3%A4tt-sv
widget = widget-sv
wwh-obd = WWH-OBD-sv
wobbelmodulering = wobbelmodulering-sv
western_test_range = western+test+range-sv
working_layer = working+layer-sv
wire = wire-sv
xylulos = xylulos-sv
wilks-rosenbaum-test = Wilks-Rosenbaum-test-sv
white_hat-hackare = white+hat-hackare-sv
wiggly_wire-system = wiggly+wire-system-sv
wimp-gränssnitt = WIMP-gr%C3%A4nssnitt-sv
webbaserad_datalagring = webbaserad+datalagring-sv
west_nile_fever = West+Nile+fever-sv
wi-fi = wi-fi-sv
ways_klassificering = Ways+klassificering-sv
watsons_u-statistika = Watsons+U-statistika-sv
xerosol = xerosol-sv
wald-wolfowitz_test = Wald-Wolfowitz+test-sv
wollastons_prisma = Wollastons+prisma-sv
xinomilin = xinomilin-sv
walds_fundamentala_identifiering = Walds+fundamentala+identifiering-sv
webbsignal = webbsignal-sv
wto:s_system_för_tvistlösning = WTO%3As+system+f%C3%B6r+tvistl%C3%B6sning-sv
xylobios = xylobios-sv
wöhlerdiagram = w%C3%B6hlerdiagram-sv
world_weather_watch = World+Weather+Watch-sv
xanthiska_korinter = xanthiska+korinter-sv
wrap_around-kartong = wrap+around-kartong-sv
whistlervågsinstabilitet = Whistlerv%C3%A5gsinstabilitet-sv
wiens_lag = Wiens+lag-sv
xenon_(133_xe) = xenon+%28133+Xe%29-sv
west_nile-feber = West+Nile-feber-sv
x-jordmån = X-jordm%C3%A5n-sv
websters_metod = Websters+metod-sv
wet_lease = wet+lease-sv
x-åtkomstprotokoll = x-%C3%A5tkomstprotokoll-sv
werenskiold_diagram = Werenskiold+diagram-sv
wiener-processen = Wiener-processen-sv
xentiorat = xentiorat-sv
weber's_tal = Weber%27s+tal-sv
waldenströms_sjukdom = Waldenstr%C3%B6ms+sjukdom-sv
wsd = WSD-sv
waemu = WAEMU-sv
wacapou = wacapou-sv
wilson-teknik = Wilson-teknik-sv
x-formmaskin = X-formmaskin-sv
xipranolol = xipranolol-sv
wilshire_5000_stamaktieindex = Wilshire+5000+stamaktieindex-sv
wilks_interna_scatter = Wilks+interna+scatter-sv
wobbler = wobbler-sv
xaf = XAF-sv
xenalipin = xenalipin-sv
xns/itp-protokoll = XNS%2FITP-protokoll-sv
welch-satterthwaite-t-test = Welch-Satterthwaite-t-test-sv
xerofyt = xerofyt-sv
world_resources_institute = World+Resources+Institute-sv
whitcomb-skrov = Whitcomb-skrov-sv
wedge = wedge-sv
weee = WEEE-sv
white-taylor-cell = White-Taylor-cell-sv
webbhotell = webbhotell-sv
waldenburg-uppställning = Waldenburg-uppst%C3%A4llning-sv
x-användare = x-anv%C3%A4ndare-sv
xnor-grind = XNOR-grind-sv
worthingtons_index = Worthingtons+index-sv
world_aids_foundation = World+AIDS+Foundation-sv
webbpost = webbpost-sv
xylenmysk = xylenmysk-sv
xerisk = xerisk-sv
wamba = wamba-sv
xylem = xylem-sv
westernsadel = westernsadel-sv
wecpnl = WECPNL-sv
xylemstråle = xylemstr%C3%A5le-sv
weston-normalelement = Weston-normalelement-sv
warrenmotor = warrenmotor-sv
x.509 = X.509-sv
wilcoxons_matchade_par_teckenrangtest = Wilcoxons+matchade+par+teckenrangtest-sv
weymouthtall-lus = weymouthtall-lus-sv
white_spot_disease = white+spot+disease-sv
while-slinga = WHILE-slinga-sv
wilcoxons_teckenrangtest = Wilcoxons+teckenrangtest-sv
warc'92 = WARC%2792-sv
wiltonmatta = wiltonmatta-sv
wfom-meddelande = WFOM-meddelande-sv
x.25-central = X.25-central-sv
wankelmotor = wankelmotor-sv
warthins_tumör = Warthins+tum%C3%B6r-sv
warmain-cyklosizer = Warmain-cyklosizer-sv
x-server = x-server-sv
xxx-syndrom = XXX-syndrom-sv
when_actually_employed = when+actually+employed-sv
xenonlaser = xenonlaser-sv
whiplashskada = whiplashskada-sv
xrf = XRF-sv
x-fog = X-fog-sv
x-armig_maskin = X-armig+maskin-sv
wire_centre = wire+centre-sv
xylitol = xylitol-sv
webbutsändning = webbuts%C3%A4ndning-sv
weimouthtallvivel = weimouthtallvivel-sv
wienkonventionen_om_traktaträtten = Wienkonventionen+om+traktatr%C3%A4tten-sv
wmo-medlem = WMO-medlem-sv
weizenbier = Weizenbier-sv
weibull-stoldts_metod = Weibull-Stoldts+metod-sv
westenbergs_interkvartila_avståndstest = Westenbergs+interkvartila+avst%C3%A5ndstest-sv
webbinarium = webbinarium-sv
wmin-index = Wmin-index-sv
xilobam = xilobam-sv
wellpapplåda = wellpappl%C3%A5da-sv
w-test_av_normalitet = W-test+av+normalitet-sv
wigner-effekt = Wigner-effekt-sv
wienkonventionen_om_ansvarighet_för_atomskada = Wienkonventionen+om+ansvarighet+f%C3%B6r+atomskada-sv
xor = XOR-sv
williams_syndrom = Williams+syndrom-sv
webbplats = webbplats-sv
wing-bar = wing-bar-sv
x-system = x-system-sv
w/o-emulsion = W%2FO-emulsion-sv
wellpappliner = wellpappliner-sv
