world_water_vision_(vision_on_water,_life_and_environment_in_the_21st_century) = World+Water+Vision+%28Vision+on+Water%2C+Life+and+Environment+in+the+21st+Century%29-da
wake_on_lan = Wake+on+LAN-da
walkie-talkie = walkie-talkie-da
warrant_med_forkøbsret = warrant+med+fork%C3%B8bsret-da
wysimolwyg = WYSIMOLWYG-da
wam = WAM-da
x-net = X-net-da
wester_schelde = Wester+Schelde-da
xerostomi = xerostomi-da
wide-body-fly = wide-body-fly-da
x-t_skriver = X-T+skriver-da
warpmaskine = warpmaskine-da
weather-ometer = weather-ometer-da
wireoplægger = wireopl%C3%A6gger-da
wide_body_container = wide+body+container-da
workshop = workshop-da
wnis = WNIS-da
wander = wander-da
wolfram_hexafluorid = wolfram+hexafluorid-da
xerofil_mikroorganisme = xerofil+mikroorganisme-da
winchester-plade = Winchester-plade-da
wada = WADA-da
worm = WORM-da
xenon-lampe = xenon-lampe-da
watchkeeping = watchkeeping-da
x.410-1984_mode = X.410-1984+mode-da
watt_pr._kilogram = watt+pr.+kilogram-da
wolfowitzs_minimumdistancemetode = Wolfowitzs+minimumdistancemetode-da
wto's_fritagelse_for_så_vidt_angår_tjenesteydelser_fra_de_mindst_udviklede_lande = WTO%27s+fritagelse+for+s%C3%A5+vidt+ang%C3%A5r+tjenesteydelser+fra+de+mindst+udviklede+lande-da
weog = WEOG-da
windcharger = windcharger-da
wuchangbrasen = wuchangbrasen-da
wearable = wearable-da
wheatstone_broprincippet = Wheatstone+broprincippet-da
wac = WAC-da
watttæthed = wattt%C3%A6thed-da
wurtzit-struktur = wurtzit-struktur-da
westfalia-metoden = Westfalia-metoden-da
wood's_light = Wood%27s+light-da
whistler = whistler-da
xylulose = xylulose-da
wild_gasoline = wild+gasoline-da
wet_lease-in = wet+lease-in-da
white_caps = white+caps-da
xenotransplantation = Xenotransplantation-da
wow = wow-da
waldeyer's_svælgring = Waldeyer%27s+sv%C3%A6lgring-da
xenon-clearance = xenon-clearance-da
wilson-kammer = Wilson-kammer-da
weils_syge = Weils+syge-da
wiens_lov_om_danseskoler_af_1996 = Wiens+lov+om+danseskoler+af+1996-da
xylometazolin = xylometazolin-da
wto's_ministerkonference = WTO%27s+Ministerkonference-da
wep = WEP-da
xylidin = Xylidin-da
westcott-model = Westcott-model-da
wannebassin = wannebassin-da
wcotp = WCOTP-da
wisla = Wisla-da
wemco-tromlesigten_adskiller_råproduktet_i_to_fraktioner = Wemco-tromlesigten+adskiller+r%C3%A5produktet+i+to+fraktioner-da
watered_effect = watered+effect-da
wash_sale-transaktion = wash+sale-transaktion-da
wire-wrapværktøj = wire-wrapv%C3%A6rkt%C3%B8j-da
who's_pilot-forskningsprojekt_vedrørende_international_kontrol_med_narkotika = WHO%27s+pilot-forskningsprojekt+vedr%C3%B8rende+international+kontrol+med+narkotika-da
werenskiold_diagram = Werenskiold+diagram-da
woltmann-måler = woltmann-m%C3%A5ler-da
wanne = wanne-da
ways_and_means-facilitet_hos_bank_of_england = Ways+and+Means-facilitet+hos+Bank+of+England-da
wto-panelet_vedrørende_helms-burton-loven = WTO-panelet+vedr%C3%B8rende+Helms-Burton-loven-da
ward_og_hales_metode = Ward+og+Hales+metode-da
wechslers_handleskala = Wechslers+handleskala-da
western_blotting = Western+blotting-da
wien-konvention_om_vejskilte = Wien-konvention+om+vejskilte-da
wolframtrioxid = wolframtrioxid-da
weekendmøde = weekendm%C3%B8de-da
weekendturisme = weekendturisme-da
wagnerit = wagnerit-da
wg_14-gruppen = WG+14-gruppen-da
whiteheart-kirsebær = whiteheart-kirseb%C3%A6r-da
whipcord = whipcord-da
weymouthfyrreblærerust = weymouthfyrrebl%C3%A6rerust-da
wilms_tumor = Wilms+tumor-da
watson-williams-test = Watson-Williams-test-da
wienerpølser = wienerp%C3%B8lser-da
wash_trading = wash+trading-da
xantinolnicotinat = xantinolnicotinat-da
xantifibrat = xantifibrat-da
x-ring = x-ring-da
wienerkonventionen_om_statssuccession_i_traktater = Wienerkonventionen+om+statssuccession+i+traktater-da
x-fuge_met_affasede_rodkanter = X-fuge+met+affasede+rodkanter-da
weu's_satellitcenter = WEU%27s+Satellitcenter-da
wulfenit = wulfenit-da
who's_udvalg_af_sagkyndige_vedrørende_narkotika-afhængighed = WHO%27s+udvalg+af+sagkyndige+vedr%C3%B8rende+narkotika-afh%C3%A6ngighed-da
warrenmotor = Warrenmotor-da
wetleasing = wetleasing-da
w = W-da
x_sar = X+SAR-da
xinomilin = xinomilin-da
washingtontraktaten_om_beskyttelse_af_intellektuel_ejendomsret_vedrørende_integrerede_kredsløb = Washingtontraktaten+om+beskyttelse+af+intellektuel+ejendomsret+vedr%C3%B8rende+integrerede+kredsl%C3%B8b-da
w/m2 = W%2Fm2-da
wet_barrel = wet+barrel-da
waterborne_agreement = Waterborne+Agreement-da
wanne_med_meget_smalt_gennemløb = wanne+med+meget+smalt+genneml%C3%B8b-da
washingtontraktaten = Washingtontraktaten-da
worden-gravimeter = Worden-gravimeter-da
x.121-adresse = X.121-adresse-da
wah = WAH-da
williamspære = williamsp%C3%A6re-da
winceyette = winceyette-da
xantocillin = xantocillin-da
wildvache = wildvache-da
weber = weber-da
wienerlim = wienerlim-da
witloof-cikorie = witloof-cikorie-da
xanthenfarvestof = xanthenfarvestof-da
wheatstone-bro = wheatstone-bro-da
wedge_bond = wedge+bond-da
weber-test = Weber-test-da
xibornol = xibornol-da
x-punkt_konfiguration = X-punkt+konfiguration-da
wroclaw = Wroclaw-da
wire_minder = wire+minder-da
window_of_circadian_low = window+of+circadian+low-da
wolframhydroxid = wolframhydroxid-da
weu_satcen = WEU+SATCEN-da
xenytropiumbromid = xenytropiumbromid-da
willow = willow-da
x.25_norm = X.25+norm-da
xamoterol = xamoterol-da
while-ordre = WHILE-ordre-da
webserver = webserver-da
wolfsbergprincipperne_til_bekæmpelse_af_hvidvaskning_af_penge = Wolfsbergprincipperne+til+bek%C3%A6mpelse+af+hvidvaskning+af+penge-da
weight_of_evidence-analyse = weight+of+evidence-analyse-da
xerotin = xerotin-da
wigner-afspænding = Wigner-afsp%C3%A6nding-da
windsurfingbræt = windsurfingbr%C3%A6t-da
w-type_integralkompressor = W-type+integralkompressor-da
weekend-billet = weekend-billet-da
wow_og_flutter = wow+og+flutter-da
wcpfc-konventionen = WCPFC-konventionen-da
xylografisk = xylografisk-da
working_families_tax_credit_(skattegodtgørelse_for_familier_i_arbejde) = Working+Families+Tax+Credit+%28skattegodtg%C3%B8relse+for+familier+i+arbejde%29-da
world_federation_of_the_deaf = World+Federation+of+the+Deaf-da
x-stumpsøm = X-stumps%C3%B8m-da
xerofytiske_græsser = xerofytiske+gr%C3%A6sser-da
wb = Wb-da
xerofyt = xerofyt-da
wfdb = WFDB-da
wienerkonvention_om_traktatretten_mellem_stater_og_internationale_organisationer_eller_mellem_internationale_organisationer_indbyrdes = Wienerkonvention+om+traktatretten+mellem+stater+og+internationale+organisationer+eller+mellem+internationale+organisationer+indbyrdes-da
wobler = wobler-da
wahoo = wahoo-da
wolframtråd = wolframtr%C3%A5d-da
way_point = way+point-da
wto's_tvistbilæggelsesordning = WTO%27s+tvistbil%C3%A6ggelsesordning-da
whiteside's_prøve = Whiteside%27s+pr%C3%B8ve-da
waferbinding = waferbinding-da
wingman = wingman-da
xerografi = xerografi-da
wcdma = WCDMA-da
xmodem-protokol = Xmodem-protokol-da
wolframoxid = wolframoxid-da
watery_stipe = watery+stipe-da
xylose-absorptionstest = xylose-absorptionstest-da
x-tilgangsprotokol = x-tilgangsprotokol-da
weu's_militære_personale = WEU%27s+milit%C3%A6re+personale-da
what_you_see_is_what_you_get = what+you+see+is+what+you+get-da
xenon = xenon-da
xanthopsia = xanthopsia-da
warneton = Warneton-da
wireføring = wiref%C3%B8ring-da
wirelag = wirelag-da
webers_tal = Webers+tal-da
weu-planlægningsenhed = WEU-planl%C3%A6gningsenhed-da
xi-symbol = Xi-symbol-da
wilson-tågekammer = Wilson-t%C3%A5gekammer-da
xaf = XAF-da
world_water_council = World+Water+Council-da
wavelet-undertrykkelse = wavelet-undertrykkelse-da
xfp = XFP-da
waasmont = Waasmont-da
whistlerbσlge = whistlerb%CF%83lge-da
wire_house = wire+house-da
w-formet_beholder = W-formet+beholder-da
widmanstätten-struktur = Widmanst%C3%A4tten-struktur-da
webcast_af_rådets_pressekonference = webcast+af+R%C3%A5dets+pressekonference-da
wilsons_isfisk = Wilsons+isfisk-da
wc-cisterne = wc-cisterne-da
ward-léonard-system = Ward-L%C3%A9onard-system-da
wattløs = wattl%C3%B8s-da
whitcomb-fuselage = Whitcomb-fuselage-da
wiengruppen = Wiengruppen-da
web_offset = web+offset-da
wr = WR-da
x-motor = X-motor-da
wagr-test = WAGR-test-da
x.25_specifikation = X.25+specifikation-da
xylen = Xylen-da
wrong-way_risikoeksponeringer = wrong-way+risikoeksponeringer-da
wig-fartøj = WIG-fart%C3%B8j-da
widget_engine = widget+engine-da
wolff-parkinsons-whites_syndrom = Wolff-Parkinsons-Whites+syndrom-da
wiretrukket_gravemaskine = wiretrukket+gravemaskine-da
x.400 = X.400-da
wto = WTO-da
xylanase = xylanase-da
wanneblok = wanneblok-da
whistlerbølger = whistlerb%C3%B8lger-da
xylemparenkym = xylemparenkym-da
webcast = webcast-da
x-y_skriver = x-y+skriver-da
walisisk = walisisk-da
x-bruger = x-bruger-da
wink_start = wink+start-da
weu-instituttet = WEU-instituttet-da
webbaseret_sundhedstjeneste = webbaseret+sundhedstjeneste-da
wic = WIC-da
wireprøvning = wirepr%C3%B8vning-da
w-motor = W-motor-da
woodbury-fordeling = Woodbury-fordeling-da
watsons_u-statistik = Watsons+U-statistik-da
wire-wrapstift = wire-wrapstift-da
wiskott-aldrichs_syndrom = Wiskott-Aldrichs+syndrom-da
wallis_og_futuna = Wallis+og+Futuna-da
wapa = WAPA-da
xdp-u50d-kompatibel = XDP-U50D-kompatibel-da
wex = WEX-da
x-windows = X-windows-da
weimar = Weimar-da
warmain-cyklon = Warmain-cyklon-da
xcd = XCD-da
wiener-hopf-teknik = Wiener-Hopf-teknik-da
wiendokumentet_om_sikkerheds-_og_tillidsskabende_foranstaltninger = Wiendokumentet+om+sikkerheds-+og+tillidsskabende+foranstaltninger-da
wilkenson-splitter = Wilkenson-splitter-da
webgrabbing = webgrabbing-da
wienerkonventionen_om_staters_repræsentation_over_for_internationale_organisationer_af_universel_karakter = Wienerkonventionen+om+staters+repr%C3%A6sentation+over+for+internationale+organisationer+af+universel+karakter-da
wegener's_granulomatose = Wegener%27s+granulomatose-da
westcott_g-faktoren = Westcott+g-faktoren-da
wide_screen-skærm = wide+screen-sk%C3%A6rm-da
wagr = WAGR-da
x-y_plotter = X-Y+plotter-da
wkb-løsning = WKB-l%C3%B8sning-da
xns/itp = XNS%2FITP-da
wub = WUB-da
wasserman-reaktion = Wasserman-reaktion-da
wap = wap-da
weekendkursus = weekendkursus-da
w-kurskurve = w-kurskurve-da
w3 = W3-da
washover_tool_joint = washover+tool+joint-da
wl = WL-da
wha = WHA-da
williams-domæner = Williams-dom%C3%A6ner-da
warsage = Warsage-da
wsm = WSM-da
wiretromle = wiretromle-da
winding-up-ordningen = winding-up-ordningen-da
wallflower = wallflower-da
xerolfthalmi = xerolfthalmi-da
wltc = WLTC-da
wkb = WKB-da
xylofon = xylofon-da
wds-system = WDS-system-da
wiretrukken_gravemaskine = wiretrukken+gravemaskine-da
weu's_ministerråd = WEU%27s+Ministerr%C3%A5d-da
wakame = wakame-da
wise_pen = Wise+Pen-da
warszawakonventionen = Warszawakonventionen-da
wavre = Wavre-da
wad-cyanid = WAD-cyanid-da
x-tjenestedefinition = x-tjenestedefinition-da
wto_plus-aftale = WTO+plus-aftale-da
warszawaerklæringen = Warszawaerkl%C3%A6ringen-da
x-open = x-open-da
whistlerbσlgeudbredelse = whistlerb%CF%83lgeudbredelse-da
wada's_bestyrelse = WADA%27s+bestyrelse-da
wanne-ovn_med_ét_ovnrum = wanne-ovn+med+%C3%A9t+ovnrum-da
weinbrand = Weinbrand-da
windshear-effekt = windshear-effekt-da
x.25_pad = X.25+PAD-da
walter_reed_klassifikation = Walter+Reed+klassifikation-da
weu = WEU-da
wienerkonventionen = Wienerkonventionen-da
watttime_virkningsgrad = watttime+virkningsgrad-da
wamu = WAMU-da
ximoprofen = ximoprofen-da
xanthophyler = xanthophyler-da
wano = WANO-da
wiskott-aldrich's_syndrom = Wiskott-Aldrich%27s+syndrom-da
wire-wrapkontakt = wire-wrapkontakt-da
watt's_parallellogram = Watt%27s+parallellogram-da
webmail = webmail-da
who's_videnskabelige_arbejdsgruppe_for_psykofarmakologisk_forskning = WHO%27s+videnskabelige+arbejdsgruppe+for+psykofarmakologisk+forskning-da
world_business_council_for_sustainable_development = World+Business+Council+for+Sustainable+Development-da
wotp = WOTP-da
winglet = winglet-da
whistleblower = whistleblower-da
weu's_integration_i_unionen = WEU%27s+integration+i+Unionen-da
weao = WEAO-da
weblog = weblog-da
wolframit = wolframit-da
wipo's_diplomatiske_konference_om_beskyttelse_af_audiovisuelle_fremførelser = WIPO%27s+diplomatiske+konference+om+beskyttelse+af+audiovisuelle+fremf%C3%B8relser-da
wirestyr = wirestyr-da
wollastonit = Wollastonit-da
watussikvæg = watussikv%C3%A6g-da
wechslers_sproglige_skala = Wechslers+sproglige+skala-da
waedm = WAEDM-da
web-crawler = web-crawler-da
weusc = WEUSC-da
wem = WEM-da
winchesterplade = winchesterplade-da
warble = warble-da
x-låsning = X-l%C3%A5sning-da
wilcoxon's_test = Wilcoxon%27s+test-da
xylotriose = xylotriose-da
white-taylor-celle = White-Taylor-celle-da
webbet = webbet-da
wassenaararrangementet_om_kontrol_med_eksporten_af_konventionelle_våben_og_varer_og_teknologier_med_dobbelt_anvendelse = Wassenaararrangementet+om+kontrol+med+eksporten+af+konventionelle+v%C3%A5ben+og+varer+og+teknologier+med+dobbelt+anvendelse-da
wanne_med_ét_forbrændingskammer = wanne+med+%C3%A9t+forbr%C3%A6ndingskammer-da
whitby_aerosolanalyseapparat = Whitby+aerosolanalyseapparat-da
white_spot_disease_hos_krebsdyr = white+spot+disease+hos+krebsdyr-da
wltc-test = WLTC-test-da
wacc = WACC-da
wests_syndrom = Wests+syndrom-da
workshop_om_videnskabelige_og_teknologiske_emner = workshop+om+videnskabelige+og+teknologiske+emner-da
x-netværk = X-netv%C3%A6rk-da
wattime = wattime-da
xantofylpalmitat = xantofylpalmitat-da
xorphanol = xorphanol-da
wenlockien = wenlockien-da
welch-satterthwaite_t-test = Welch-Satterthwaite+t-test-da
xerga = xerga-da
wai = WAI-da
weymouthfyrrens_blærerust = Weymouthfyrrens+bl%C3%A6rerust-da
watt_pr_kvadratmeter = watt+pr+kvadratmeter-da
wiggler = wiggler-da
wilms_svulst = Wilms+svulst-da
wienerkonventionen_om_traktatretten = Wienerkonventionen+om+traktatretten-da
weigle-reaktivering = Weigle-reaktivering-da
wanderu = wanderu-da
we = We-da
wincey = wincey-da
xaliproden = xaliproden-da
wallenbergs_syndrom = Wallenbergs+syndrom-da
wamba = wamba-da
x-akse_vibration = x-akse+vibration-da
weu's_situationscenter = WEU%27s+Situationscenter-da
wye-memorandummet = Wye-memorandummet-da
wash_sale = wash+sale-da
walthers_formel = Walthers+formel-da
wst = WST-da
wienerklæringen = Wienerkl%C3%A6ringen-da
worst-case_fan-out = worst-case+fan-out-da
xpf = XPF-da
watttimemåler_til_vekselstrøm = watttimem%C3%A5ler+til+vekselstr%C3%B8m-da
wobbeltone = wobbeltone-da
whp = WHP-da
w3c = W3C-da
xanoxinsyre = xanoxinsyre-da
w/kg = W%2Fkg-da
weu's_hurtige_operative_eurostyrke = WEU%27s+hurtige+operative+eurostyrke-da
wirestyring = wirestyring-da
wigner-kraft = Wigner-kraft-da
wirestrammer = wirestrammer-da
webbaseret_e-mail = webbaseret+e-mail-da
xylazin = xylazin-da
x-spænding = X-sp%C3%A6nding-da
wiggins_gasbeholder = Wiggins+gasbeholder-da
wienerkonventionen_om_statssuccession_i_ejendom,_arkiver_og_gæld = Wienerkonventionen+om+statssuccession+i+ejendom%2C+arkiver+og+g%C3%A6ld-da
windshear = windshear-da
wro = WRO-da
wollastonit = wollastonit-da
watsons_u2n-test = Watsons+U2N-test-da
wankel-motor_med_to_sæt_arbejdselementer = Wankel-motor+med+to+s%C3%A6t+arbejdselementer-da
winston_koncentrator = Winston+koncentrator-da
windfall_profit = windfall+profit-da
wienhandlingsprogrammet_for_videnskab_og_teknologi_til_udviklingsformål = Wienhandlingsprogrammet+for+videnskab+og+teknologi+til+udviklingsform%C3%A5l-da
wratten-filter = Wratten-filter-da
whiting's_stigbord = Whiting%27s+stigbord-da
web_bug = web+bug-da
wc-sæde = WC-s%C3%A6de-da
wienerkonventionen_om_diplomatiske_forbindelser = Wienerkonventionen+om+diplomatiske+forbindelser-da
wg_14 = WG+14-da
wolds_markov-intervalproces = Wolds+Markov-intervalproces-da
xerostomia = xerostomia-da
werd = WERD-da
wired-or_forbindelse = wired-OR+forbindelse-da
wc-låg = WC-l%C3%A5g-da
who's_internationale_norm_for_drikkevand = WHO%27s+internationale+norm+for+drikkevand-da
wagner-bjælke = Wagner-bj%C3%A6lke-da
workaround = workaround-da
wafer,_som_endnu_ikke_er_udskåret_i_chips = wafer%2C+som+endnu+ikke+er+udsk%C3%A5ret+i+chips-da
xyloporose = xyloporose-da
web_spant = web+spant-da
x = X-da
wafer_skåret_i_mikroplader = wafer+sk%C3%A5ret+i+mikroplader-da
white_noise = white+noise-da
xylografi = xylografi-da
wifi4eu-ordningen = WiFi4EU-ordningen-da
wrap-around_etiket = wrap-around+etiket-da
wox = WOX-da
wild_weasel = wild+weasel-da
wto-ministerkonferencen = WTO-Ministerkonferencen-da
x-bånds-radar = X-b%C3%A5nds-radar-da
wireboreværktøj = wireborev%C3%A6rkt%C3%B8j-da
wilcoxon-test = Wilcoxon-test-da
wafer_udbytte = wafer+udbytte-da
woulff_flaske = Woulff+flaske-da
wafer_fangst = wafer+fangst-da
xenygloxal = xenygloxal-da
xylem-initial = xylem-initial-da
wye_river-memorandummet = Wye+River-memorandummet-da
xhc-fri_forrensning = XHC-fri+forrensning-da
x-skala = X-skala-da
xylem-modercelle = xylem-modercelle-da
who = WHO-da
wenra = WENRA-da
wigner-wilkins_metode = Wigner-Wilkins+metode-da
wilcoxons_test_for_to_udvalg = Wilcoxons+test+for+to+udvalg-da
winpad = Winpad-da
xylograf = xylograf-da
weu-sikkerhedsaftalen = WEU-sikkerhedsaftalen-da
weibull-stoldts_metode = Weibull-Stoldts+metode-da
wbcsd = WBCSD-da
wattløs_effekt = wattl%C3%B8s+effekt-da
wipo = WIPO-da
wto's_status = WTO%27s+status-da
x-snit_krystal = x-snit+krystal-da
west_midlands_dual_system = West+Midlands+Dual+System-da
wire-wrapforbindelse = wire-wrapforbindelse-da
welzijnswet = Welzijnswet-da
wsn = WSN-da
wagners_nordrand-foryngelsessystem = Wagners+nordrand-foryngelsessystem-da
walton's_stigbord = Walton%27s+stigbord-da
webbaseret_mail = webbaseret+mail-da
w-priskurve = w-priskurve-da
wavelet_transform = wavelet+transform-da
wattstrøm = wattstr%C3%B8m-da
xanthopsi = xanthopsi-da
xenobiotisk_stof = xenobiotisk+stof-da
x-,y-,z-,... = x-%2Cy-%2Cz-%2C...-da
wipo's_traktat_om_fremførelser_og_fonogrammer = WIPO%27s+traktat+om+fremf%C3%B8relser+og+fonogrammer-da
warp_dressing = warp+dressing-da
wauthier-braine = Wauthier-Braine-da
wetlease = wetlease-da
warszawapagten = Warszawapagten-da
xylenisomer = xylenisomer-da
wilks_interne_spredning = Wilks+interne+spredning-da
whistlerbσlgeinstabilitet = Whistlerb%CF%83lgeinstabilitet-da
wien-konvention_om_færdsel = Wien-konvention+om+f%C3%A6rdsel-da
wiso = WISO-da
wto's_sekretariat = WTO%27s+Sekretariat-da
wire = wire-da
w-vinge = W-vinge-da
washingtonkonventionen = Washingtonkonventionen-da
weu's_militærkomité = WEU%27s+Milit%C3%A6rkomit%C3%A9-da
warrant = warrant-da
wired_or = wired+OR-da
wiener-khintchine-sætning = Wiener-Khintchine-s%C3%A6tning-da
writing_speed = writing+speed-da
week-end_hytte = week-end+hytte-da
xanthofyler = xanthofyler-da
weu's_parlamentariske_forsamling = WEU%27s+Parlamentariske+Forsamling-da
wus = WUS-da
wall_street = Wall+Street-da
wavellit = wavellit-da
whiteout = whiteout-da
white_hat-hacker = white+hat-hacker-da
xmodem = Xmodem-da
wilcoxons_parvise_fortegnsrangfølgetest = Wilcoxons+parvise+fortegnsrangf%C3%B8lgetest-da
x-armet_maskine = x-armet+maskine-da
x-bånd = X-b%C3%A5nd-da
weu's_råd = WEU%27s+R%C3%A5d-da
wc = WC-da
wolfram-lysbuesvejsning_med_inaktiv_gas = wolfram-lysbuesvejsning+med+inaktiv+gas-da
warc = WARC-da
xylenækvivalent = xylen%C3%A6kvivalent-da
weu-instituttet = WEU-Instituttet-da
wvii-x = WVII-X-da
websted = websted-da
wattc = WATTC-da
wolframophosphat = wolframophosphat-da
wald-wolfowitz_runs-test = Wald-Wolfowitz+runs-test-da
xerofil = xerofil-da
waxdick = waxdick-da
wirelås = wirel%C3%A5s-da
wellingtonkonventionen_om_mineralforekomsterne_i_antarktis = Wellingtonkonventionen+om+mineralforekomsterne+i+Antarktis-da
xylobiose = xylobiose-da
wop = WOP-da
wash_out-mængde = wash+out-m%C3%A6ngde-da
whiskey = whiskey-da
wto's_almindelige_råd = WTO%27s+Almindelige+R%C3%A5d-da
wienerkonventionen_om_hurtig_underretning_om_kernekraftulykker = Wienerkonventionen+om+hurtig+underretning+om+kernekraftulykker-da
western_blot = western+blot-da
world_confederation_of_organizations_of_the_teaching_profession = World+Confederation+of+Organizations+of+the+Teaching+Profession-da
weir_skimmer = weir+skimmer-da
wolframglødelampe = wolframgl%C3%B8delampe-da
x2_-_fordeling = X2+-+fordeling-da
xylamidintosilat = xylamidintosilat-da
wecafc = WECAFC-da
w_min.-indeks = W+min.-indeks-da
wannefødeovn = wannef%C3%B8deovn-da
wire_til_ramslag = wire+til+ramslag-da
wienhandlingsplanen = Wienhandlingsplanen-da
win-win-løsning = win-win-l%C3%B8sning-da
xerisk_sand = xerisk+sand-da
web-harvesting = web-harvesting-da
wilcoxon_mann-whitney-test = Wilcoxon+Mann-Whitney-test-da
x.25-port = X.25-port-da
weaver_indeks = weaver+indeks-da
xemilofiban = xemilofiban-da
xenotransplantation = xenotransplantation-da
wmd = WMD-da
who's_videnskabelige_arbejdsgruppe_for_neurofysiologisk_forskning_og_adfærdsstudier_inden_for_psykiatri = WHO%27s+videnskabelige+arbejdsgruppe+for+neurofysiologisk+forskning+og+adf%C3%A6rdsstudier+inden+for+psykiatri-da
watermark = watermark-da
xy-skriver = XY-skriver-da
w-statistik = W-statistik-da
wireless_markup_language = Wireless+Markup+Language-da
xanthorroeaharpiks = xanthorroeaharpiks-da
world_aids_foundation = World+AIDS+Foundation-da
wirelig = wirelig-da
wide_base_fælg = wide+base+f%C3%A6lg-da
wired-and_forbindelse = wired-AND+forbindelse-da
walsh-transformation = Walsh-Transformation-da
x-parallakse = x-parallakse-da
xanomelin = xanomelin-da
weichseltræ = weichseltr%C3%A6-da
xenbucin = xenbucin-da
world_administrative_radio_conference = World+Administrative+Radio+Conference-da
weekendarbejde = weekendarbejde-da
whip = whip-da
webkonference = webkonference-da
wirespil = wirespil-da
watson-crick-modellen = Watson-Crick-modellen-da
world_wide_web_consortium = World+Wide+Web+Consortium-da
web_accessibility_initiative = Web+Accessibility+Initiative-da
xanthiol = xanthiol-da
x-bunden_nedarvning = X-bunden+nedarvning-da
webspant-plade = webspant-plade-da
windscale_avanceret_gaskølet_reaktor = Windscale+avanceret+gask%C3%B8let+reaktor-da
xylem = xylem-da
xtc = XTC-da
xenysalat = xenysalat-da
wc-børste = wc-b%C3%B8rste-da
wash_primer = wash+primer-da
wanne_med_to_forbrændingskamre = wanne+med+to+forbr%C3%A6ndingskamre-da
weag = WEAG-da
website = website-da
walds_sekventielle_test = Walds+sekventielle+test-da
wd = WD-da
widrow-hoffs_regel = Widrow-Hoffs+regel-da
wireless_application_protocol = Wireless+Application+Protocol-da
wandhjul = wandhjul-da
wolframelektrode = Wolframelektrode-da
xanthin = xanthin-da
wilson-hilferty-transformation = Wilson-Hilferty-transformation-da
wideband_cdma = Wideband+CDMA-da
wks = WKS-da
white_board = white+board-da
wolfe = wolfe-da
wilking = wilking-da
whatman-papir = Whatman-papir-da
xrf = XRF-da
walkman = walkman-da
weizenbier = weizenbier-da
waferprøvning = waferpr%C3%B8vning-da
wilpf = WILPF-da
wire_eller_kæde_på_en_lossebom = wire+eller+k%C3%A6de+p%C3%A5+en+lossebom-da
wattnormering = wattnormering-da
x-server = x-server-da
wf = WF-da
wc-cisterne_bestående_af_cisterne_og_mekanisme = wc-cisterne+best%C3%A5ende+af+cisterne+og+mekanisme-da
webcasting = webcasting-da
warrenit = warrenit-da
worst-case_afprøvning = worst-case+afpr%C3%B8vning-da
wien = Wien-da
weu-rådets_arbejdsgruppe = WEU-R%C3%A5dets+Arbejdsgruppe-da
wobbelmoduleret = wobbelmoduleret-da
x-højde = x-h%C3%B8jde-da
wing-in-ground-fartøj = wing-in-ground-fart%C3%B8j-da
wcarrd = WCARRD-da
xof = XOF-da
xyloxemin = xyloxemin-da
xenisme = xenisme-da
wawa = wawa-da
wash_trade = wash+trade-da
wassenaararrangementet = Wassenaararrangementet-da
x.25-central = X.25-central-da
wetted-wall_kolonne = wetted-wall+kolonne-da
x2_-_test = X2+-+test-da
x-system = x-system-da
worst-case_kredsløbselement = worst-case+kredsl%C3%B8bselement-da
westphalvægt = Westphalv%C3%A6gt-da
wing-web-stab_anvendelse = Wing-web-stab+anvendelse-da
whistleblowing = whistleblowing-da
xerotermisk = xerotermisk-da
willy-willy = willy-willy-da
winsor-estimation = Winsor-estimation-da
wilshire_5000-aktieindeks = Wilshire+5000-aktieindeks-da
www = WWW-da
w-kompressor = W-kompressor-da
witherit = witherit-da
wide-cut-brændstof = wide-cut-br%C3%A6ndstof-da
x-område = X-omr%C3%A5de-da
wilton-tæppe_med_tre_skudtråde/islættråde = wilton-t%C3%A6ppe+med+tre+skudtr%C3%A5de%2Fisl%C3%A6ttr%C3%A5de-da
wash_load = wash+load-da
wireline_core_barrel = wireline+core+barrel-da
wolframkatode = wolframkatode-da
willstätter_lignin = Willst%C3%A4tter+lignin-da
xns/itp-protokol = XNS%2FITP-protokol-da
xenogen = xenogen-da
waremme = Waremme-da
waldenströms's_makroglobulinæmi = Waldenstr%C3%B6ms%27s+makroglobulin%C3%A6mi-da
white_compression = white+compression-da
westernsadel = westernsadel-da
weu's_satellitcenter = WEU%27s+satellitcenter-da
weston_normalcelle = Weston+normalcelle-da
webhosting = webhosting-da
weichsel = weichsel-da
wireless_fidelity = wireless+fidelity-da
wecpnl = WECPNL-da
whisky-soda = whisky-soda-da
xylemstråle = xylemstr%C3%A5le-da
x_funktion = X+funktion-da
wall_street-analytiker = Wall+Street-analytiker-da
wto-overenskomsten = WTO-overenskomsten-da
wolframsyre = wolframsyre-da
xenazonsyre = xenazonsyre-da
welmm-metode = WELMM-metode-da
wøhlerkurve = w%C3%B8hlerkurve-da
xdb_båndbredde = xdB+b%C3%A5ndbredde-da
wipo's_traktat_om_ophavsret = WIPO%27s+traktat+om+ophavsret-da
walking_beam-ovn = walking+beam-ovn-da
wetmop-holder = wetmop-holder-da
walking_tractor = walking+tractor-da
wobbelmodulation = wobbelmodulation-da
weru = weru-da
watt_per_kanal = watt+per+kanal-da
xeroradiografi = xeroradiografi-da
waypoint = waypoint-da
wilks_tomcelletest = Wilks+tomcelletest-da
weu's_permanente_råd = WEU%27s+Permanente+R%C3%A5d-da
waterproof_læder = waterproof+l%C3%A6der-da
waters_projektion = Waters+projektion-da
wood-block = wood-block-da
wannebund = wannebund-da
western-overførsel = Western-overf%C3%B8rsel-da
wiens_lov = Wiens+lov-da
wide_area_information_server = Wide+Area+Information+Server-da
wienkonventionen_om_civilretligt_ansvar_for_nuklear_skade = Wienkonventionen+om+civilretligt+ansvar+for+nuklear+skade-da
wulo = wulo-da
warren-bjælke = Warren-bj%C3%A6lke-da
wire_board = wire+board-da
xenomorf = xenomorf-da
wec = WEC-da
white_space = white+space-da
wgig = WGIG-da
windward_islands = Windward+Islands-da
wood_worker's_lung = wood+worker%27s+lung-da
websters_metode = Websters+metode-da
xinidamin = xinidamin-da
wcpc = WCPC-da
wet-only-opsamling = wet-only-opsamling-da
whittle-fordeling = Whittle-fordeling-da
wienstrategi_for_europa = Wienstrategi+for+Europa-da
webbanner = webbanner-da
wishart-fordelingen = Wishart-fordelingen-da
wurtzit = wurtzit-da
ww_spærfag = WW+sp%C3%A6rfag-da
wmo-medlem = WMO-medlem-da
xenon-effekt = xenon-effekt-da
west-køler = West-k%C3%B8ler-da
xml_schema_definition = XML+Schema+Definition-da
wakestrømning = wakestr%C3%B8mning-da
what_you_see_is_what_you_get = What+You+See+is+What+You+Get-da
walshoutem = Walshoutem-da
wct = WCT-da
wild_card-option = wild+card-option-da
wsq = WSQ-da
wwsscc = WWSSCC-da
x-akse_chok = x-akse+chok-da
walker-sandsynlighedsfunktion = Walker-sandsynlighedsfunktion-da
waitro = WAITRO-da
weekendfixer = weekendfixer-da
white_lined_chipboard = white+lined+Chipboard-da
weight_of_evidence = weight+of+evidence-da
wilm's_tumor = Wilm%27s+tumor-da
webfeed = webfeed-da
wirespændingsregulatorer = wiresp%C3%A6ndingsregulatorer-da
wmd-strategi = WMD-strategi-da
wolff-parkinson-whites_syndrom = Wolff-Parkinson-Whites+syndrom-da
who-unaids-eu-samarbejdscentret = WHO-UNAIDS-EU-Samarbejdscentret-da
wirekran = wirekran-da
world_wide_web = World+Wide+Web-da
wp = WP-da
wssv = WSSV-da
web-spider = web-spider-da
wienerkonventionen_om_konsulære_forbindelser = Wienerkonventionen+om+konsul%C3%A6re+forbindelser-da
wmo = WMO-da
web-robot = web-robot-da
wejtidsdiagram = wejtidsdiagram-da
wolfhound-obligation = wolfhound-obligation-da
ward-leonard-aggregat = Ward-Leonard-aggregat-da
wcpfc = WCPFC-da
wcmc = WCMC-da
white_spirit = white+spirit-da
wilton-tæppe_med_to_skudtråde/islættråde = wilton-t%C3%A6ppe+med+to+skudtr%C3%A5de%2Fisl%C3%A6ttr%C3%A5de-da
white-box_information = white-box+information-da
webtjeneste = webtjeneste-da
xeu = XEU-da
wengé = weng%C3%A9-da
wobbelfrekvens = wobbelfrekvens-da
xylokemi = xylokemi-da
willowcalf = willowcalf-da
wirewrap_værktøj = wirewrap+v%C3%A6rkt%C3%B8j-da
wfc = WFC-da
wigner-energi = Wigner-energi-da
western-aftryk = Western-aftryk-da
white_base_coat = white+base+coat-da
warrants_uden_udløbsdato = warrants+uden+udl%C3%B8bsdato-da
weymouthsfyr = Weymouthsfyr-da
xylose = xylose-da
wilks-lawley_u1-statistik = Wilks-Lawley+U1-statistik-da
wattmeter = wattmeter-da
xitsonga = xiTsonga-da
wrocław = Wroc%C5%82aw-da
xipamid = xipamid-da
wilsons_tågekammer = Wilsons+t%C3%A5gekammer-da
w-indeks = W-indeks-da
xilobam = xilobam-da
xn-symbol = Xn-symbol-da
wiendokumentet = Wiendokumentet-da
wig = WIG-da
wingers_metode = Wingers+metode-da
wearable-teknologi = wearable-teknologi-da
waxy-majs = waxy-majs-da
white-collar-kriminalitet = white-collar-kriminalitet-da
wash-primer = wash-primer-da
wattimemåler = wattimem%C3%A5ler-da
w.c. = w.c.-da
waferstepper = waferstepper-da
warc'92 = WARC%2792-da
weekend_på_en_græsgang_i_alperne = weekend+p%C3%A5+en+gr%C3%A6sgang+i+Alperne-da
xenonlampe = xenonlampe-da
wolframkarbid = wolframkarbid-da
whisteside-prøven = Whisteside-pr%C3%B8ven-da
wcc = WCC-da
waverider = waverider-da
wmc = WMC-da
xenipenton = xenipenton-da
wood-lampe = wood-lampe-da
whl = WHL-da
xylografisk_tryk = xylografisk+tryk-da
wilsons_stormsvale = Wilsons+stormsvale-da
wire_centre = wire+centre-da
x-enhed = X-enhed-da
wltp = WLTP-da
wick-tampon = wick-tampon-da
working_range = working+range-da
wellington = Wellington-da
whitworth_gevind = Whitworth+gevind-da
wobbel = wobbel-da
wfd = WFD-da
x-400-standarden_for_elektronisk_post = X-400-standarden+for+elektronisk+post-da
xbrl = XBRL-da
watttimekapacitet = watttimekapacitet-da
webhotel = webhotel-da
wto,_oecd,_handelsspørgsmål_inden_for_landbrug_og_fiskeri._eksportkreditpolitik = WTO%2C+OECD%2C+handelssp%C3%B8rgsm%C3%A5l+inden+for+landbrug+og+fiskeri.+Eksportkreditpolitik-da
world_weather_watch = World+Weather+Watch-da
wto's_teknisk_samarbejdstjeneste = WTO%27s+teknisk+samarbejdstjeneste-da
wolfram-ædelgassvejsning = wolfram-%C3%A6delgassvejsning-da
wmd-centret = WMD-centret-da
whisker = whisker-da
xenon_(133_xe) = xenon+%28133+Xe%29-da
wildernessprojekt = Wildernessprojekt-da
wihogne = Wihogne-da
wolds_opløsningssætning = Wolds+opl%C3%B8sningss%C3%A6tning-da
wap-telefon = wap-telefon-da
weu-rådet = WEU-R%C3%A5det-da
x.509 = X.509-da
white_knight = white+knight-da
wkk = WKK-da
weu-topmøde = WEU-topm%C3%B8de-da
wcrp = WCRP-da
wulfe = wulfe-da
wolfram = wolfram-da
wal = WAL-da
wolframbåndlampe = wolframb%C3%A5ndlampe-da
warszawasystemet = Warszawasystemet-da
whisky = whisky-da
x.25_kryptering = X.25+kryptering-da
whitewood = whitewood-da
wet_look = wet+look-da
xerosere = xerosere-da
x-kanal = X-kanal-da
wilkenson-combiner = Wilkenson-combiner-da
wiredreven_afbryder = wiredreven+afbryder-da
willemstad = Willemstad-da
wind_shear = wind+shear-da
wwf = WWF-da
webbrowser = webbrowser-da
white_box_afprøvning = white+box+afpr%C3%B8vning-da
watt = watt-da
wolframmalm = wolframmalm-da
worcestersauce = worcestersauce-da
x-hul = x-hul-da
wc = wc-da
willow-maskine = willow-maskine-da
whiplash = whiplash-da
wald-fordeling = Wald-fordeling-da
xn = Xn-da
waines = Waines-da
while-sløjfe = WHILE-sl%C3%B8jfe-da
x_25_anbefaling = X+25+anbefaling-da
webmaster = webmaster-da
wolframbuelampe = wolframbuelampe-da
wilson_teknik = Wilson+teknik-da
washington = Washington-da
wearable-elektronik = wearable-elektronik-da
wto's_tvistbilæggelsessystem = WTO%27s+tvistbil%C3%A6ggelsessystem-da
williams_syndrom = Williams+syndrom-da
xanthokromi = xanthokromi-da
webkommunikationsenheden = Webkommunikationsenheden-da
wisers_metode = Wisers+metode-da
xenyhexeninsyre = xenyhexeninsyre-da
whitworth_rørgevind = Whitworth+r%C3%B8rgevind-da
wdha-syndrom = WDHA-syndrom-da
xylol = xylol-da
weimartrekant = Weimartrekant-da
webværktøjer = webv%C3%A6rkt%C3%B8jer-da
wirebeskytter = wirebeskytter-da
x-lås = X-l%C3%A5s-da
weaver_flammehastighed = weaver+flammehastighed-da
waxy_corn = waxy+corn-da
weu-politielement = WEU-politielement-da
wri = WRI-da
xip = XIP-da
wheatstone's_automatiske_system = Wheatstone%27s+automatiske+system-da
weg = WEG-da
wistar-rotte = Wistar-rotte-da
wehab = WEHAB-da
willison-kobling = Willison-kobling-da
xanthophyll = xanthophyll-da
wenner-konfiguration = Wenner-konfiguration-da
xanthangummi = xanthangummi-da
wgs = WGS-da
wireklemme = wireklemme-da
wobbelgenerator = wobbelgenerator-da
wolf-maskine = wolf-maskine-da
whipples_sygdom = Whipples+sygdom-da
wafer_netto_fangst = wafer+netto+fangst-da
wellingtontraktaten_om_antarktis = Wellingtontraktaten+om+Antarktis-da
wa-karakteristisk_ladning = Wa-karakteristisk+ladning-da
wkp = WKP-da
whitworth_fingevind = Whitworth+fingevind-da
xilitol = xilitol-da
wocl = WOCL-da
wijs_metode = Wijs+metode-da
water_loop = water+loop-da
wwc = WWC-da
windhoek = Windhoek-da
warda = WARDA-da
wide_area_network = Wide+Area+Network-da
workshop_om_traditionel_viden_og_biodiversitet = workshop+om+traditionel+viden+og+biodiversitet-da
whs = WHS-da
wobbetal = Wobbetal-da
wåler-rose's_test = W%C3%A5ler-Rose%27s+test-da
warszawa = Warszawa-da
wattløs_strøm = wattl%C3%B8s+str%C3%B8m-da
wiring_board = wiring+board-da
wienerbrød = wienerbr%C3%B8d-da
w-normalitetstest = W-normalitetstest-da
wavar-adgang = WAVAR-adgang-da
webtilgængelighed = webtilg%C3%A6ngelighed-da
xenthiorat = xenthiorat-da
wankelmotor = wankelmotor-da
wais = WAIS-da
waferhåndteringssystem = waferh%C3%A5ndteringssystem-da
wp_15 = WP+15-da
warfarin = warfarin-da
xylan = xylan-da
wco = WCO-da
xantochromia = xantochromia-da
winkelmanns_operation = Winkelmanns+operation-da
xenon-udladningslampe = xenon-udladningslampe-da
weiss-område = Weiss-omr%C3%A5de-da
wolframstål = wolframst%C3%A5l-da
writhe_number = writhe+number-da
wolfram-inertgas = wolfram-inertgas-da
write_once_read_many = write+once+read+many-da
wolframcarbid = wolframcarbid-da
wracs = WRACS-da
wfp = WFP-da
wilsons_sygdom = Wilsons+sygdom-da
world_plan_of_action_on_the_ozone_layer = World+Plan+of+Action+on+the+Ozone+Layer-da
walds_fundamentale_identifikation = Walds+fundamentale+identifikation-da
xdsl = xDSL-da
wml = WML-da
waiver = waiver-da
watt_spidseffekt = watt+spidseffekt-da
warchalking = warchalking-da
xenalipin = xenalipin-da
wobbegong = wobbegong-da
wilton_tæppe = wilton+t%C3%A6ppe-da
warthin's_tumor = Warthin%27s+tumor-da
windsorformation = windsorformation-da
wider_window-forslag = Wider+Window-forslag-da
waverider-bøje = waverider-b%C3%B8je-da
xr-goniometer = XR-goniometer-da
x-klient = x-klient-da
wolframsyreanhydrid = wolframsyreanhydrid-da
wankelmotor = Wankelmotor-da
xenotim = xenotim-da
webspant_i_siden = webspant+i+siden-da
xenical = Xenical-da
whiptail_wallaby_kænguru = Whiptail+Wallaby+k%C3%A6nguru-da
wood-lampe = Wood-lampe-da
weekly_circular = weekly+circular-da
wto-overenskomst = WTO-overenskomst-da
wto's_sekretariat = WTO%27s+sekretariat-da
whiting's_ligevægtssystem = Whiting%27s+ligev%C3%A6gtssystem-da
wood's_light-undersøgelse = Wood%27s+light-unders%C3%B8gelse-da
whistler-bølgeinstabilitet = Whistler-b%C3%B8lgeinstabilitet-da
wavelet_scalar_quantisation = wavelet+scalar+quantisation-da
wet_blue_læder = wet+blue+l%C3%A6der-da
werdnig-hoffmanns_sygdom = Werdnig-Hoffmanns+sygdom-da
westfalen = Westfalen-da
ward-leonard-system = Ward-Leonard-system-da
wesselsbron_virus = Wesselsbron+virus-da
walds_klassifikationsstatistik = Walds+klassifikationsstatistik-da
xenon-simulator = xenon-simulator-da
wpa = WPA-da
xylocumarol = xylocumarol-da
xml = XML-da
white_spot_syndrome-virus = white+spot+syndrome-virus-da
wcip = WCIP-da
x-autosom_translokation = X-autosom+translokation-da
x-systemprotokol = x-systemprotokol-da
wire-wrap_forbindelse = wire-wrap+forbindelse-da
walkzone = walkzone-da
walker-warburg-syndrom = Walker-Warburg-syndrom-da
xipranolol = xipranolol-da
wire-wrap = wire-wrap-da
w-faktor = W-faktor-da
x-fuge = X-fuge-da
win-win-situation = win-win-situation-da
who's_laboratory_biosafety_manual = WHO%27s+Laboratory+Biosafety+Manual-da
xi = Xi-da
xanthofyl = xanthofyl-da
wolframborid = wolframborid-da
xylenol = xylenol-da
xenobiotikum = xenobiotikum-da
webadresse = webadresse-da
wkx = WKX-da
xanthinoxidase = xanthinoxidase-da
webside = webside-da
webcrawling = webcrawling-da
wcl = WCL-da
westphalit = westphalit-da
wireless_callnote = wireless+callnote-da
wienerklæringen_og_-handlingsprogrammet = Wienerkl%C3%A6ringen+og+-handlingsprogrammet-da
xantofyl = xantofyl-da
wet_lease-out = wet+lease-out-da
wald-wolfowitz-test = Wald-Wolfowitz-test-da
wienerkonventionen_om_beskyttelse_af_ozonlaget = Wienerkonventionen+om+beskyttelse+af+ozonlaget-da
xenogenisk = xenogenisk-da
wsis = WSIS-da
xantofyler = xantofyler-da
wankel-motor = Wankel-motor-da
wgcs = WGCS-da
warrant_til_statspapirer = warrant+til+statspapirer-da
wire-wrap_sokkel = wire-wrap+sokkel-da
weag-panel = WEAG-Panel-da
waldmann-docutest = Waldmann-docutest-da
x-anvendelsesgrænseflade = x-anvendelsesgr%C3%A6nseflade-da
webmasterenheden = Webmasterenheden-da
wmd-fri_zone = WMD-fri+zone-da
wfom-meddelelse = WFOM-meddelelse-da
whale_solubles = whale+solubles-da
webers_forsøg = Webers+fors%C3%B8g-da
wire-bar = wire-bar-da
xylidin = xylidin-da
whitworth_normalgevind = Whitworth+normalgevind-da
wigner-vækst = Wigner-v%C3%A6kst-da
wellhead-tryk = wellhead-tryk-da
wysiwyg = WYSIWYG-da
wiki = wiki-da
willcoxons_test_for_ét_udvalg = Willcoxons+test+for+%C3%A9t+udvalg-da
who's_ekspertudvalg_vedrørende_medicinafhængighed = WHO%27s+Ekspertudvalg+vedr%C3%B8rende+Medicinafh%C3%A6ngighed-da
xibenolol = xibenolol-da
wevenit = wevenit-da
watt_pr._kvadratmeter = watt+pr.+kvadratmeter-da
widmannstaettisk_struktur = widmannstaettisk+struktur-da
whois = Whois-da
wol = WOL-da
weathering = weathering-da
world_confederation_of_teachers = World+Confederation+of+Teachers-da
winkler-metoden = Winkler-metoden-da
wireline-boring = wireline-boring-da
wollastons_prisme = Wollastons+prisme-da
wales = Wales-da
who's_samarbejdscenter_for_overvågning_af_og_forskning_i_rabies = WHO%27s+samarbejdscenter+for+overv%C3%A5gning+af+og+forskning+i+rabies-da
wid = WID-da
wira = wira-da
wash_out = wash+out-da
wolframmolybdatpigment = wolframmolybdatpigment-da
wignernuklider = Wignernuklider-da
warszawapagtens_organisation = Warszawapagtens+Organisation-da
wolframat = wolframat-da
wmd-mc = WMD-MC-da
